Player,G,MP,FG,FGA,3P,3PA,3P%,2P,2PA,2P%,eFG%,FT,FTA,FT%,ORB,DRB,TRB,AST,STL,BLK,TOV,PF,PTS,TS%,TOV%
A.J. Slaughter,23,524,80,206,40,109,0.37,40,97,0.41,0.49,24,30,0.8,6,40,46,39,10,1,27,56,224,0.51,10.97
AJ Guyton,14,252,31,80,14,42,0.33,17,38,0.45,0.48,11,17,0.6,5,16,21,13,11,0,11,25,87,0.5,11.17
Aaron Doornekamp,58,1122,101,265,65,179,0.36,36,86,0.42,0.5,48,62,0.75,40,140,180,72,35,11,30,119,315,0.54,9.31
Aaron Jackson,178,3501,406,825,110,300,0.37,296,525,0.56,0.56,173,227,0.76,77,248,325,457,117,5,211,298,1095,0.59,18.58
Aaron Miles,30,940,114,266,24,61,0.39,90,205,0.44,0.47,53,78,0.68,18,82,100,107,48,4,64,66,305,0.51,17.57
Aaron Mitchell,11,93,14,32,5,12,0.42,9,20,0.45,0.52,7,11,0.65,3,4,7,9,6,0,6,15,40,0.54,14.01
Aaron White,85,1807,226,438,37,106,0.35,189,332,0.57,0.56,144,186,0.79,80,241,321,63,36,21,68,165,633,0.61,11.57
Aboubakar Zaki,10,87,5,12,0,1,0.0,5,11,0.45,0.42,3,9,0.33,6,14,20,2,1,5,4,13,13,0.41,20.04
Achille Polonara,27,338,29,89,9,40,0.22,20,49,0.41,0.38,18,28,0.64,31,44,75,6,15,11,7,29,85,0.42,6.46
Acie Law,60,1366,159,375,29,88,0.33,130,287,0.45,0.46,107,146,0.73,15,94,109,134,40,3,99,113,454,0.52,18.39
Adam Chubb,16,282,44,75,1,1,1.0,43,74,0.58,0.59,32,44,0.73,18,48,66,2,6,4,19,57,121,0.64,16.76
Adam Hanga,156,3740,465,1028,126,409,0.31,339,619,0.55,0.51,222,321,0.68,134,469,603,338,160,94,193,365,1278,0.55,14.17
Adam Hess,14,370,49,109,21,54,0.39,28,55,0.51,0.55,28,38,0.74,23,30,53,18,9,2,15,43,147,0.58,10.66
Adam Hrycaniuk,44,509,43,95,0,5,0.0,43,90,0.48,0.45,24,26,0.92,48,94,142,10,18,9,34,99,110,0.52,24.21
Adam Lapeta,14,230,21,38,0,2,0.0,21,36,0.58,0.55,13,20,0.57,25,23,48,3,4,2,11,34,55,0.59,19.03
Adam Waczynski,27,510,96,192,51,103,0.5,45,89,0.51,0.63,29,35,0.83,25,37,62,30,20,1,26,47,272,0.66,11.14
Adam Wojcik,95,2136,369,751,59,175,0.34,310,576,0.54,0.53,233,327,0.71,125,201,326,71,64,64,167,243,1030,0.58,15.73
Adas Juskevicius,23,205,18,44,4,12,0.33,14,32,0.44,0.45,8,11,0.73,7,18,25,15,4,1,17,11,48,0.49,25.82
Ademola Okulaja,52,1411,221,467,45,133,0.34,176,334,0.53,0.52,95,169,0.55,119,233,352,79,67,16,84,99,582,0.54,13.43
Adreian Payne,25,356,68,133,17,48,0.35,51,85,0.6,0.58,41,57,0.7,32,53,85,12,10,9,24,52,194,0.61,13.18
Adrian Autry,18,383,44,88,13,32,0.41,31,56,0.55,0.57,29,48,0.6,9,32,41,21,17,1,39,46,130,0.6,26.33
Adrien Moerman,142,3394,497,1101,164,476,0.34,333,625,0.53,0.53,114,146,0.77,168,579,747,143,124,37,138,304,1272,0.55,10.59
Ahmet Tuncer,9,61,9,20,6,13,0.46,3,7,0.43,0.6,2,3,0.67,1,3,4,14,4,0,4,9,26,0.61,15.8
Ainars Bagatskis,29,507,60,149,46,111,0.41,14,38,0.37,0.56,42,47,0.89,10,36,46,16,13,0,19,61,208,0.61,10.07
Ajdin Penava,4,13,0,5,0,4,0.0,0,1,0.0,0.0,2,2,1.0,1,3,4,0,0,0,0,0,2,0.17,0.0
Akeem Vargas,24,324,14,52,11,34,0.32,3,18,0.17,0.38,4,8,0.5,2,28,30,13,13,1,9,65,43,0.39,13.95
Akin Akingbala,8,237,41,72,0,1,0.0,41,71,0.58,0.57,14,32,0.44,22,33,55,4,10,8,15,15,96,0.56,14.84
Alain Digbeu,49,978,106,262,53,159,0.33,53,103,0.51,0.51,80,102,0.79,32,94,126,53,49,20,64,113,345,0.56,17.26
Alain Koffi,10,168,18,50,0,1,0.0,18,49,0.37,0.36,9,16,0.56,13,14,27,7,6,8,13,18,45,0.39,18.56
Alan Anderson,47,1323,194,462,54,148,0.36,140,314,0.45,0.48,168,202,0.85,41,127,168,86,64,13,120,144,610,0.55,17.89
Alan Gregov,4,36,1,8,0,5,0.0,1,3,0.33,0.12,2,2,1.0,0,2,2,4,0,0,4,8,4,0.23,31.06
Alan Tomidy,21,264,40,72,2,5,0.4,38,67,0.57,0.57,25,38,0.58,30,34,64,6,6,6,20,34,107,0.6,18.4
Albert Miralles,24,432,48,93,1,2,0.5,47,91,0.52,0.52,27,48,0.56,35,56,91,19,5,7,25,76,124,0.54,17.97
Albert Oliver,28,409,36,111,16,48,0.33,20,63,0.32,0.4,26,29,0.9,14,23,37,93,9,1,38,43,114,0.46,23.49
Alberto Abalde,48,977,135,293,43,107,0.4,92,186,0.49,0.53,56,73,0.8,44,100,144,80,19,0,51,73,369,0.57,13.56
Alberto Angulo,32,590,95,179,11,29,0.38,84,150,0.56,0.56,30,39,0.72,10,54,64,29,37,1,52,45,231,0.59,20.95
Alberto Corbacho,21,223,26,65,17,54,0.31,9,11,0.82,0.53,2,2,1.0,6,17,23,8,3,1,7,20,71,0.54,9.6
Alberto Diaz,54,910,57,168,32,108,0.3,25,60,0.42,0.43,19,25,0.75,16,49,65,102,40,0,45,135,165,0.46,20.09
Alberto Herreros,62,1446,204,448,110,268,0.41,94,180,0.52,0.58,141,173,0.81,41,109,150,73,62,5,61,110,659,0.63,10.43
Aldo Curti,10,223,20,46,7,19,0.37,13,27,0.48,0.51,16,21,0.76,1,7,8,36,13,0,23,33,63,0.57,29.4
Alec Peters,63,956,101,221,54,127,0.43,47,94,0.5,0.58,47,54,0.87,36,117,153,40,26,5,32,126,303,0.62,11.56
Alejandro Montecchia,22,458,52,120,30,84,0.36,22,36,0.61,0.56,30,34,0.82,5,47,52,53,19,0,31,61,164,0.61,18.68
Aleks Maric,18,459,85,140,0,2,0.0,85,138,0.62,0.61,92,142,0.65,61,90,151,22,22,11,46,55,262,0.65,18.51
Aleksandar Capin,32,471,49,134,17,64,0.27,32,70,0.46,0.43,27,35,0.76,16,30,46,55,14,0,39,39,142,0.48,20.7
Aleksandar Glintic,11,102,10,26,4,9,0.44,6,17,0.35,0.46,0,2,0.0,4,11,15,2,4,2,10,19,24,0.45,27.11
Aleksandar Mitrovic,19,51,3,5,2,2,1.0,1,3,0.33,0.8,6,10,0.6,1,2,3,4,0,0,5,12,14,0.74,34.72
Aleksandar Rasic,57,1001,109,307,69,198,0.35,40,109,0.37,0.47,76,86,0.91,16,51,67,104,30,1,78,75,363,0.53,18.45
Aleksandar Smiljanic,23,416,59,134,14,60,0.23,45,74,0.61,0.49,55,66,0.84,10,20,30,26,21,1,37,49,187,0.57,18.5
Aleksandar Ugrinoski,2,16,1,3,1,1,1.0,0,2,0.0,0.5,0,2,0.0,1,0,1,1,1,0,3,1,3,0.39,43.6
Aleksandar Vezenkov,119,1545,226,431,84,206,0.41,142,225,0.63,0.62,83,98,0.88,74,197,271,73,46,14,42,137,619,0.65,8.14
Aleksander Djordjevic,27,622,115,213,55,119,0.46,60,94,0.64,0.67,88,98,0.9,7,37,44,63,16,2,57,56,373,0.73,18.2
Aleksander Nadjfeji,26,562,94,180,1,12,0.08,93,168,0.55,0.52,39,68,0.57,24,54,78,48,19,5,58,71,228,0.54,21.65
Aleksej Nesovic,10,169,18,45,9,22,0.41,9,23,0.39,0.5,6,8,0.75,5,17,22,13,6,0,23,25,51,0.53,32.16
Aleksej Nikolic,51,523,38,100,17,53,0.32,21,47,0.45,0.46,27,29,0.96,5,30,35,72,11,1,30,81,120,0.53,21.01
Aleksej Pokusevski,2,6,0,3,0,1,0.0,0,2,0.0,0.0,1,2,0.5,1,1,2,1,1,0,1,1,1,0.13,20.49
Aleksey Zozulin,6,32,4,5,3,4,0.75,1,1,1.0,1.1,1,2,0.5,3,4,7,1,0,1,0,4,12,1.02,0.0
Alen Omic,39,619,90,169,1,6,0.17,89,163,0.55,0.54,37,64,0.47,77,83,160,24,11,11,35,68,218,0.55,15.08
Alessandro Abbio,41,969,101,225,49,118,0.42,52,107,0.49,0.56,77,107,0.73,20,72,92,47,42,4,56,111,328,0.6,17.07
Alessandro Cittadini,14,279,29,45,1,2,0.5,28,43,0.65,0.66,18,28,0.64,26,40,66,6,15,4,20,50,77,0.67,25.87
Alessandro De Pol,14,172,9,37,2,16,0.12,7,21,0.33,0.27,28,38,0.74,6,14,20,4,5,0,9,20,48,0.45,14.35
Alessandro Gentile,80,1800,311,729,61,199,0.31,250,530,0.47,0.47,171,248,0.67,59,145,204,166,53,13,144,186,854,0.51,14.66
Alessandro Piazza,2,4,1,2,0,1,0.0,1,1,1.0,0.5,1,1,1.0,0,1,1,1,0,0,1,0,3,0.61,29.07
Alessandro Tonolli,37,694,40,102,24,64,0.38,16,38,0.42,0.51,29,36,0.86,32,74,106,29,41,19,29,133,133,0.56,19.75
Alex Abrines,122,1973,278,618,143,379,0.38,135,239,0.56,0.57,116,141,0.83,56,145,201,89,62,16,67,212,815,0.6,8.97
Alex Acker,57,1411,189,443,36,117,0.31,153,326,0.47,0.47,114,138,0.72,48,152,200,80,64,15,115,114,528,0.52,18.59
Alex Garcia,23,428,38,91,14,37,0.38,24,54,0.44,0.49,25,40,0.62,8,40,48,32,19,1,21,63,115,0.53,16.2
Alex King,65,805,63,168,31,105,0.3,32,63,0.51,0.47,7,24,0.16,35,51,86,33,20,3,36,90,164,0.46,16.78
Alex Kirk,16,160,22,41,0,1,0.0,22,40,0.55,0.54,10,15,0.67,20,16,36,5,1,14,9,30,54,0.57,15.9
Alex Mumbru,69,1657,228,528,82,250,0.33,146,278,0.53,0.51,135,181,0.75,60,200,260,139,53,7,128,169,673,0.55,17.4
Alex Perez,7,75,8,20,3,6,0.5,5,14,0.36,0.48,3,3,1.0,3,3,6,13,3,0,3,13,22,0.52,12.34
Alex Renfroe,73,1616,185,413,70,171,0.41,115,242,0.48,0.53,94,120,0.83,64,160,224,299,74,6,165,157,534,0.57,26.16
Alex Righetti,29,576,82,177,41,99,0.41,41,78,0.53,0.58,50,55,0.94,17,44,61,8,23,2,24,83,255,0.63,10.66
Alex Scales,27,719,123,290,55,152,0.36,68,138,0.49,0.52,50,77,0.64,15,64,79,34,38,3,46,58,351,0.54,12.44
Alex Tyus,91,1580,315,487,0,4,0.0,315,483,0.65,0.65,100,197,0.5,149,253,402,30,37,110,81,140,730,0.64,12.37
Alexander Lokhmanchuk,13,289,42,117,14,56,0.25,28,61,0.46,0.42,31,46,0.67,28,36,64,6,23,8,21,57,118,0.43,13.27
Alexander Miloserdov,5,43,2,14,1,9,0.11,1,5,0.2,0.18,2,2,1.0,1,0,1,1,1,0,3,9,7,0.24,16.78
Alexandr Bashminov,45,600,96,171,5,12,0.42,91,159,0.57,0.58,52,75,0.64,61,94,155,19,17,35,29,99,249,0.61,12.45
Alexandre Petrenko,20,368,68,128,17,40,0.42,51,88,0.58,0.6,26,43,0.6,25,46,71,16,20,1,17,56,179,0.61,10.37
Alexandros Nikolaidis,3,23,1,4,0,2,0.0,1,2,0.5,0.25,4,4,1.0,0,5,5,0,5,0,4,2,6,0.52,40.98
Alexey Pegushin,11,121,16,35,9,22,0.41,7,13,0.54,0.59,3,6,0.5,2,5,7,11,1,1,5,23,44,0.58,11.73
Alexey Savrasenko,23,315,48,85,0,1,0.0,48,84,0.57,0.56,9,24,0.38,46,47,93,9,4,22,16,42,105,0.55,14.34
Alexey Shved,134,3565,726,1766,345,980,0.35,381,786,0.48,0.51,483,588,0.8,51,280,331,599,137,35,353,258,2280,0.56,14.85
Alexey Zhukanenko,27,163,26,52,4,8,0.5,22,44,0.5,0.54,8,15,0.55,7,27,34,5,1,11,13,20,64,0.55,18.16
Alexis Ajinca,9,228,63,114,0,1,0.0,63,113,0.56,0.55,28,37,0.76,15,34,49,17,7,8,20,32,154,0.59,13.31
Alexis Papadatos,21,266,34,68,21,40,0.52,13,28,0.46,0.65,10,12,0.81,7,25,32,18,11,0,24,43,99,0.68,24.67
Alfonso Sanchez,9,63,2,15,1,9,0.11,1,6,0.17,0.17,3,6,0.5,1,1,2,2,2,0,4,13,8,0.23,18.48
Ali Bouziane,7,55,5,18,2,7,0.29,3,11,0.27,0.33,2,2,1.0,2,1,3,8,2,1,8,9,14,0.37,29.76
Ali Traore,15,288,56,100,0,1,0.0,56,99,0.57,0.56,30,41,0.73,20,37,57,5,8,9,21,31,142,0.6,15.1
Allan Ray,21,512,56,178,26,82,0.32,30,96,0.31,0.39,43,51,0.81,12,42,54,48,21,1,47,63,181,0.45,18.99
Alonzo Gee,3,86,12,28,4,7,0.57,8,21,0.38,0.5,5,6,0.83,0,19,19,3,0,1,6,8,33,0.54,16.38
Aloysius Anagonye,18,340,50,101,1,4,0.25,49,97,0.51,0.5,21,29,0.72,40,47,87,9,13,11,20,58,122,0.54,14.95
Alper Yilmaz,72,1179,57,166,37,127,0.29,20,39,0.51,0.45,19,28,0.65,27,104,131,91,78,10,44,148,170,0.48,19.79
Alphonso Ford,54,1826,438,869,87,220,0.4,351,649,0.54,0.55,237,294,0.81,71,140,211,146,81,21,161,155,1200,0.6,13.89
Alvin Sims,3,36,2,10,1,4,0.25,1,6,0.17,0.25,4,5,0.8,1,2,3,0,3,0,5,7,9,0.37,29.07
Alvin Young,8,204,40,83,9,19,0.47,31,64,0.48,0.54,19,25,0.76,7,20,27,11,9,0,16,16,108,0.57,14.55
Amara Sy,13,207,22,53,1,7,0.14,21,46,0.46,0.42,7,13,0.54,12,16,28,8,7,8,12,28,52,0.44,16.97
Amare Stoudemire,6,33,2,5,0,1,0.0,2,4,0.5,0.4,4,4,1.0,1,4,5,1,1,0,1,5,8,0.59,12.89
Amath M'Baye,30,530,62,134,25,66,0.38,37,68,0.54,0.56,34,43,0.79,14,47,61,28,11,3,21,72,183,0.6,12.07
Amedeo Della Valle,33,325,44,92,20,44,0.45,24,48,0.5,0.59,40,47,0.92,13,15,28,13,11,3,7,39,148,0.66,5.85
Amine Noua,25,352,50,102,15,46,0.33,35,56,0.62,0.56,10,16,0.62,14,37,51,8,8,7,21,52,125,0.57,16.15
Amit Tamir,9,106,12,41,3,20,0.15,9,21,0.43,0.33,5,6,0.83,11,18,29,3,4,3,9,12,32,0.37,17.1
Anderson Varejao,49,808,106,208,9,34,0.26,97,174,0.56,0.53,51,100,0.5,72,125,197,16,40,29,58,120,272,0.54,18.71
Andrae Patterson,13,250,40,74,6,17,0.35,34,57,0.6,0.58,20,32,0.62,15,34,49,8,9,9,20,24,106,0.6,18.5
Andre Barrett,14,172,18,46,6,23,0.26,12,23,0.52,0.46,9,10,0.9,5,11,16,24,5,0,13,7,51,0.51,20.5
Andre Owens,28,706,87,207,17,55,0.31,70,152,0.46,0.46,40,59,0.69,11,72,83,75,32,4,44,63,231,0.5,15.89
Andrea Bargnani,53,796,139,284,37,93,0.4,102,191,0.53,0.55,77,108,0.65,40,98,138,17,29,28,60,121,392,0.59,15.32
Andrea Cinciarini,98,1572,151,345,34,98,0.35,117,247,0.47,0.49,77,113,0.57,46,153,199,182,48,4,93,186,413,0.52,19.07
Andrea Crosariol,16,355,40,75,0,1,0.0,40,74,0.54,0.53,19,30,0.63,26,54,80,14,13,15,31,43,99,0.56,26.01
Andrea Meneghin,34,888,102,260,56,155,0.36,46,105,0.44,0.5,47,61,0.75,17,59,76,68,50,6,54,121,307,0.54,15.84
Andrea Michelori,7,96,5,16,1,2,0.5,4,14,0.29,0.34,13,18,0.72,9,16,25,2,3,0,10,15,24,0.5,29.48
Andrea Pecile,26,439,56,136,19,57,0.33,37,79,0.47,0.48,46,71,0.64,11,26,37,29,15,0,36,56,177,0.53,17.71
Andrei Fetisov,8,217,29,67,15,34,0.44,14,33,0.42,0.54,26,31,0.84,8,36,44,14,11,15,16,28,99,0.61,16.56
Andrei Ivanov,4,32,1,9,0,4,0.0,1,5,0.2,0.11,4,4,1.0,0,3,3,1,0,0,3,4,6,0.28,21.8
Andrei Kirilenko,28,720,101,191,26,61,0.43,75,130,0.58,0.6,105,143,0.72,44,141,185,53,38,46,34,54,333,0.66,11.81
Andrei Malcev,9,114,12,32,10,24,0.42,2,8,0.25,0.53,3,4,0.75,3,8,11,2,3,0,3,21,37,0.55,8.16
Andrej Stimac,44,729,70,175,38,109,0.35,32,66,0.48,0.51,28,38,0.8,33,69,102,26,22,3,31,75,206,0.54,13.92
Andres Miso,12,196,28,59,6,20,0.3,22,39,0.56,0.53,14,24,0.58,6,9,15,12,10,1,13,19,76,0.55,15.75
Andres Nocioni,172,3532,607,1317,193,528,0.37,414,789,0.52,0.53,330,434,0.74,138,613,751,146,99,110,273,421,1737,0.58,15.33
Andres Rodriguez,14,442,29,69,10,31,0.32,19,38,0.5,0.49,17,22,0.77,9,28,37,46,24,0,25,47,85,0.54,24.11
Andrew Albicy,27,580,58,157,37,105,0.35,21,52,0.4,0.49,25,44,0.57,12,32,44,90,24,1,42,42,178,0.5,19.23
Andrew Goudelock,74,2094,429,906,160,389,0.41,269,517,0.52,0.56,128,148,0.86,25,153,178,162,44,8,106,133,1146,0.59,9.84
Andrew Harrison,4,89,11,32,7,15,0.47,4,17,0.24,0.45,6,9,0.67,0,8,8,10,2,2,3,10,35,0.49,7.7
Andrew Sullivan,17,260,29,64,4,15,0.27,25,49,0.51,0.48,11,21,0.52,7,21,28,5,10,5,13,22,73,0.5,15.07
Andrew Wisniewski,42,1069,115,245,38,97,0.39,77,148,0.52,0.55,58,79,0.75,21,64,85,92,42,2,51,115,326,0.58,15.42
Andrey Sheyko,7,67,3,9,0,2,0.0,3,7,0.43,0.33,1,3,0.33,5,3,8,5,2,1,11,9,7,0.34,51.59
Andrey Vorontsevich,268,4574,553,1200,256,639,0.4,297,561,0.53,0.57,166,227,0.76,239,604,843,261,121,108,154,450,1528,0.59,10.59
Andrey Zubkov,103,1231,154,342,48,142,0.34,106,200,0.53,0.52,59,85,0.69,54,136,190,66,34,10,61,166,415,0.55,13.85
Andrija Ciric,15,237,31,70,7,31,0.23,24,39,0.62,0.49,14,17,0.82,13,15,28,7,8,0,18,23,83,0.54,18.85
Andrija Zizic,92,1999,341,621,3,8,0.38,338,613,0.55,0.55,222,308,0.7,161,264,425,53,40,7,146,300,907,0.6,16.18
Andrius Giedraitis,28,747,114,204,34,63,0.54,80,141,0.57,0.64,113,132,0.85,26,56,82,48,29,3,35,68,375,0.72,11.78
Andrius Jurkunas,17,425,61,121,32,72,0.44,29,49,0.59,0.64,24,39,0.45,10,43,53,17,17,14,32,64,178,0.64,18.81
Andrius Slezas,24,233,20,67,12,47,0.26,8,20,0.4,0.39,15,21,0.84,15,24,39,9,11,3,12,34,67,0.44,13.6
Andrzej Adamek,7,81,2,15,1,10,0.1,1,5,0.2,0.17,0,2,0.0,0,3,3,8,7,0,6,9,5,0.16,27.42
Andy Panko,22,524,57,154,9,40,0.22,48,114,0.42,0.4,21,34,0.62,26,58,84,25,6,3,20,60,144,0.43,10.58
Andzejs Pasecniks,22,371,64,132,1,7,0.14,63,125,0.5,0.49,29,52,0.56,41,38,79,9,11,9,14,55,158,0.51,8.29
Angelo Caloiaro,48,1121,109,231,34,105,0.32,75,126,0.6,0.55,69,86,0.8,78,118,196,66,49,3,31,111,321,0.6,10.34
Angelo Gigli,39,759,86,172,19,54,0.35,67,118,0.57,0.56,37,61,0.72,60,96,156,19,40,22,58,92,228,0.57,22.58
Ansu Sesay,42,1186,141,369,58,160,0.36,83,209,0.4,0.46,62,79,0.79,50,147,197,45,45,33,57,123,402,0.5,12.37
Antanas Kavaliauskas,64,801,140,224,0,2,0.0,140,222,0.63,0.62,77,97,0.8,75,93,168,40,15,12,64,169,357,0.67,19.35
Ante Delas,8,100,10,28,7,18,0.39,3,10,0.3,0.48,7,7,1.0,1,4,5,6,5,0,3,12,34,0.55,8.8
Ante Grgourevic,2,49,4,8,2,3,0.67,2,5,0.4,0.62,2,2,1.0,2,7,9,0,0,0,1,6,12,0.68,10.12
Ante Masic,9,122,10,25,8,23,0.35,2,2,1.0,0.56,2,2,1.0,2,16,18,4,2,0,4,16,30,0.58,13.39
Ante Tomic,144,2982,574,955,0,5,0.0,574,950,0.6,0.6,230,388,0.6,263,537,800,246,70,85,203,340,1378,0.61,15.28
Anthony Bowie,27,736,82,184,32,81,0.4,50,103,0.49,0.53,57,73,0.79,20,68,88,56,21,4,53,60,253,0.59,19.69
Anthony Dobbins,10,245,17,54,4,22,0.18,13,32,0.41,0.35,4,9,0.44,10,26,36,15,18,5,11,10,42,0.36,15.95
Anthony Gill,70,1648,269,470,63,155,0.41,206,315,0.65,0.64,132,171,0.79,104,198,302,82,34,38,79,181,733,0.67,12.66
Anthony Giovacchini,9,149,6,21,0,7,0.0,6,14,0.43,0.29,8,9,0.89,3,11,14,9,7,0,13,24,20,0.4,34.25
Anthony Goldwire,11,257,28,74,9,31,0.29,19,43,0.44,0.44,11,20,0.55,7,12,19,16,14,0,17,31,76,0.46,17.03
Anthony Parker,90,3152,510,966,83,202,0.41,427,764,0.56,0.57,364,445,0.81,64,460,524,287,147,33,172,223,1467,0.63,12.9
Anthony Randolph,130,2880,548,1151,174,450,0.39,374,701,0.53,0.55,256,339,0.74,148,467,615,128,89,79,145,208,1526,0.59,10.03
Antoine Diot,55,1050,86,234,42,128,0.33,44,106,0.42,0.46,45,59,0.71,15,68,83,144,46,4,99,110,259,0.5,27.58
Antoine Rigaudeau,70,1923,277,540,105,238,0.44,172,302,0.57,0.61,185,213,0.86,26,117,143,128,98,7,118,213,844,0.67,15.7
Anton Gavel,70,1994,220,526,89,244,0.36,131,282,0.46,0.5,128,161,0.8,32,112,144,202,50,5,82,140,657,0.55,12.08
Anton Ponkrashov,107,1265,130,349,34,132,0.26,96,217,0.44,0.42,53,88,0.61,34,114,148,141,43,6,96,121,347,0.45,19.85
Anton Pushkov,17,111,14,35,1,3,0.33,13,32,0.41,0.41,3,4,0.75,8,9,17,5,4,4,14,23,32,0.44,27.58
Anton Yudin,16,142,14,32,10,22,0.45,4,10,0.4,0.59,1,1,1.0,2,9,11,10,5,0,6,22,39,0.6,15.61
Antonio Granger,94,2694,408,871,204,465,0.44,204,406,0.5,0.59,125,174,0.59,88,242,330,76,74,21,111,192,1145,0.6,10.49
Antonio Graves,4,80,7,26,2,8,0.25,5,18,0.28,0.31,2,2,1.0,1,5,6,4,2,1,8,9,18,0.33,22.94
Antonio Porta,9,127,6,20,2,10,0.2,4,10,0.4,0.35,11,14,0.79,1,6,7,9,5,0,9,19,25,0.48,25.6
Antonios Koniaris,24,321,28,74,20,48,0.42,8,26,0.31,0.51,5,6,0.83,8,25,33,34,16,1,24,60,81,0.53,23.85
Antonis Fotsis,250,5649,660,1362,304,745,0.41,356,617,0.58,0.6,293,377,0.78,337,787,1124,176,148,97,212,427,1917,0.63,12.18
Antywane Robinson,10,255,45,113,8,27,0.3,37,86,0.43,0.43,9,12,0.75,27,31,58,3,5,7,12,20,107,0.45,9.21
Arda Vekiloglu,27,307,29,91,6,32,0.19,23,59,0.39,0.35,14,21,0.82,20,22,42,5,12,2,12,39,78,0.39,10.69
Ariel Eslava,5,19,1,9,0,1,0.0,1,8,0.12,0.11,1,2,0.5,0,1,1,0,0,0,0,5,3,0.15,0.0
Arijan Komazec,8,172,28,52,7,18,0.39,21,34,0.62,0.61,13,14,0.93,6,11,17,7,5,0,10,27,76,0.65,14.67
Arnaldo De Sousa,3,30,1,7,1,5,0.2,0,2,0.0,0.21,2,2,1.0,0,1,1,8,1,0,5,2,5,0.32,38.82
Arnas Butkevicius,10,205,24,43,8,17,0.47,16,26,0.62,0.65,14,27,0.52,7,21,28,11,9,5,14,22,70,0.64,20.33
Arriel McDonald,67,1872,236,493,61,172,0.35,175,321,0.55,0.54,162,208,0.83,31,123,154,200,110,8,96,178,695,0.59,14.11
Arthur Lee,12,377,54,106,7,21,0.33,47,85,0.55,0.54,40,44,0.91,4,19,23,20,24,0,28,30,155,0.62,18.26
Artsiom Parakhouski,23,579,118,192,0,2,0.0,118,190,0.62,0.61,62,90,0.69,47,106,153,18,15,45,31,44,298,0.64,11.81
Artur Drozdov,67,1438,187,386,56,142,0.39,131,244,0.54,0.56,44,84,0.45,57,134,191,73,52,24,83,98,474,0.56,16.4
Arturas Gudaitis,46,700,95,184,3,10,0.3,92,174,0.53,0.52,107,156,0.67,71,110,181,18,14,40,39,95,300,0.59,13.37
Arturas Jomantas,42,983,86,181,14,45,0.31,72,136,0.53,0.51,63,87,0.73,40,115,155,74,43,6,70,117,249,0.57,24.2
Arturas Karnisovas,30,748,112,257,42,119,0.35,70,138,0.51,0.52,79,97,0.81,36,88,124,40,35,5,44,66,345,0.58,12.8
Arturas Masiulis,6,67,6,17,0,1,0.0,6,16,0.38,0.35,3,4,0.75,1,10,11,0,1,5,6,13,15,0.4,24.23
Arturas Milaknis,207,4300,489,1105,365,864,0.42,124,241,0.51,0.61,120,150,0.72,66,258,324,166,97,11,147,391,1463,0.62,11.15
Arvydas Macijauskas,56,1597,292,584,103,264,0.39,189,320,0.59,0.59,288,319,0.92,23,106,129,125,87,8,122,118,975,0.67,14.41
Arvydas Sabonis,18,509,107,191,15,41,0.37,92,150,0.61,0.6,71,102,0.7,43,150,193,43,18,29,36,46,300,0.64,13.24
Arvydas Siksnius,6,23,1,3,0,2,0.0,1,1,1.0,0.33,2,2,1.0,0,2,2,2,2,0,0,6,4,0.52,0.0
Asier Garcia,23,244,30,83,13,30,0.43,17,53,0.32,0.44,11,16,0.75,14,27,41,7,8,6,14,29,84,0.47,13.46
Asim Pars,18,306,51,110,0,1,0.0,51,109,0.47,0.46,34,57,0.6,27,25,52,17,10,5,28,54,136,0.5,17.17
Assaf Dotan,10,13,2,4,0,1,0.0,2,3,0.67,0.5,2,2,1.0,0,0,0,0,0,0,0,1,6,0.61,0.0
Augustine Rubit,56,1048,162,295,15,35,0.43,147,260,0.57,0.57,122,152,0.81,94,125,219,43,33,19,59,135,461,0.64,14.02
Augusto Lima,30,333,42,87,4,17,0.24,38,70,0.54,0.51,19,37,0.52,20,58,78,3,8,7,23,51,107,0.52,18.21
Austin Daye,25,463,74,167,33,73,0.45,41,94,0.44,0.54,36,41,0.88,9,65,74,26,12,7,27,59,217,0.59,12.73
Austin Hollins,27,616,98,229,51,147,0.35,47,82,0.57,0.54,33,36,0.92,27,31,58,40,37,9,32,66,280,0.57,11.56
Austin Nichols,10,233,34,89,11,40,0.28,23,49,0.47,0.44,32,37,0.86,3,19,22,5,4,0,17,23,111,0.53,13.9
Awudu Abass,33,417,37,96,17,46,0.37,20,50,0.4,0.47,23,28,0.75,22,33,55,14,14,6,17,50,114,0.53,13.57
Axel Hervelle,99,2056,269,556,83,207,0.4,186,349,0.53,0.56,115,169,0.69,191,272,463,83,79,35,115,269,736,0.58,15.43
Axel Toupane,70,1024,128,287,42,120,0.35,86,167,0.51,0.52,88,121,0.68,34,94,128,37,29,8,55,115,386,0.57,13.92
Aymeric Jeanneau,24,513,34,80,6,31,0.19,28,49,0.57,0.46,18,26,0.72,6,35,41,64,13,1,47,63,92,0.5,33.95
Balsa Radunovic,11,153,15,40,3,15,0.2,12,25,0.48,0.41,9,12,0.75,6,17,23,12,9,2,12,28,42,0.46,20.95
Barak Peleg,10,191,20,64,3,23,0.13,17,41,0.41,0.34,3,6,0.5,12,14,26,9,10,2,23,31,46,0.35,25.66
Baris Ermis,37,347,36,70,9,27,0.33,27,43,0.63,0.58,8,18,0.54,9,18,27,45,16,2,34,53,89,0.57,30.38
Baris Hersek,14,112,12,35,4,16,0.25,8,19,0.42,0.4,5,8,0.75,4,13,17,6,6,1,9,17,33,0.43,18.94
Barisa Krasic,66,1008,113,283,58,153,0.38,55,130,0.42,0.5,55,66,0.71,38,95,133,15,24,19,48,181,339,0.54,13.33
Bekir Yarangume,9,65,5,13,1,5,0.2,4,8,0.5,0.42,4,6,0.67,1,7,8,5,3,0,3,3,15,0.48,16.09
Ben Bentil,23,209,19,52,7,22,0.32,12,30,0.4,0.43,26,31,0.84,21,25,46,10,3,1,4,31,71,0.54,5.74
Ben Hansbrough,12,149,10,31,6,22,0.27,4,9,0.44,0.42,1,2,0.5,5,12,17,10,5,0,7,28,27,0.42,18.0
Ben Woodside,7,141,15,44,4,13,0.31,11,31,0.35,0.39,8,9,0.89,5,10,15,13,8,0,5,14,42,0.44,9.44
Benjamin Dewar,9,167,12,31,6,20,0.3,6,11,0.55,0.48,8,8,1.0,2,11,13,6,5,1,4,21,38,0.55,10.38
Benjamin Eze,60,999,137,251,1,5,0.2,136,246,0.55,0.55,54,102,0.57,88,147,235,18,55,55,73,141,329,0.56,19.79
Benjamin Ortner,10,157,17,40,0,1,0.0,17,39,0.44,0.42,2,4,0.5,10,14,24,5,2,2,8,22,36,0.43,16.08
Bennett Davison,34,856,146,314,5,21,0.24,141,293,0.48,0.47,60,97,0.61,77,140,217,28,45,19,73,116,357,0.5,16.99
Beno Udrih,69,1521,189,409,33,110,0.3,156,299,0.52,0.5,107,146,0.67,28,112,140,165,80,5,115,146,518,0.55,19.55
Berk Demir,28,256,25,63,7,28,0.25,18,35,0.51,0.45,10,11,0.91,21,37,58,7,4,9,14,33,67,0.49,17.11
Berk Ugurlu,24,153,16,38,2,9,0.22,14,29,0.48,0.45,6,10,0.52,1,6,7,14,6,2,11,20,40,0.47,20.6
Bernd Kruel,13,172,21,44,0,3,0.0,21,41,0.51,0.48,21,29,0.72,14,27,41,7,8,0,12,28,63,0.55,17.45
Berni Rodriguez,169,3655,407,953,185,490,0.38,222,463,0.48,0.52,255,317,0.81,68,237,305,357,126,8,269,401,1254,0.57,19.76
Billy Baron,26,640,99,236,56,139,0.4,43,97,0.44,0.54,47,55,0.86,9,61,70,58,21,1,31,35,301,0.58,10.65
Billy Keys,16,466,54,128,32,88,0.36,22,40,0.55,0.55,19,23,0.83,7,21,28,42,17,0,32,37,159,0.58,18.81
Birkan Batuk,103,1368,116,295,71,202,0.35,45,93,0.48,0.51,30,50,0.61,52,93,145,35,42,5,31,245,333,0.53,8.91
Blagota Sekulic,56,793,101,187,7,27,0.26,94,160,0.59,0.56,34,71,0.5,78,84,162,7,26,11,34,98,243,0.56,13.48
Blake Ahearn,9,202,27,72,13,36,0.36,14,36,0.39,0.47,19,21,0.9,2,13,15,14,0,1,15,23,86,0.53,15.59
Blake Schilb,47,1301,203,420,48,144,0.33,155,276,0.56,0.54,71,85,0.83,44,138,182,182,40,8,101,75,525,0.57,18.09
Blake Stepp,13,364,55,119,37,82,0.45,18,37,0.49,0.62,23,29,0.79,5,24,29,32,14,1,28,34,170,0.65,17.53
Bo McCalebb,106,2847,503,965,72,214,0.34,431,751,0.57,0.56,312,391,0.81,106,176,282,286,173,3,183,248,1390,0.61,13.86
Bob Menama,7,53,1,3,0,1,0.0,1,2,0.5,0.33,2,2,1.0,2,11,13,0,0,0,3,13,4,0.52,43.6
Bobby Brown,39,1025,166,433,63,204,0.31,103,229,0.45,0.46,141,163,0.77,8,44,52,149,17,3,87,69,536,0.53,14.7
Bobby Dixon,149,2996,478,1081,282,688,0.41,196,393,0.5,0.57,147,168,0.85,64,254,318,368,114,3,215,282,1385,0.6,15.69
Bogdan Bogdanovic,108,3037,452,1081,197,524,0.38,255,557,0.46,0.51,221,276,0.8,61,295,356,333,116,33,219,242,1322,0.55,15.41
Bojan Bakic,27,367,31,77,10,38,0.26,21,39,0.54,0.47,34,43,0.78,10,12,22,17,19,1,17,50,106,0.55,15.05
Bojan Bogdanovic,86,2420,409,891,126,351,0.36,283,540,0.52,0.53,255,324,0.73,55,160,215,107,59,28,137,160,1199,0.58,11.7
Bojan Brkic,6,55,3,8,1,5,0.2,2,3,0.67,0.44,3,4,0.75,0,2,2,2,1,0,2,4,10,0.51,17.01
Bojan Dubljevic,58,1278,265,532,65,176,0.37,200,356,0.56,0.56,156,187,0.85,109,211,320,84,35,10,90,110,751,0.61,12.78
Bojan Popovic,58,1295,118,312,32,120,0.27,86,192,0.45,0.43,172,204,0.86,21,113,134,133,75,3,112,133,440,0.55,21.8
Boniface N'Dong,55,996,198,338,1,3,0.33,197,335,0.59,0.59,104,154,0.68,86,167,253,22,21,65,73,119,501,0.62,15.25
Bootsy Thornton,138,3646,463,1075,131,387,0.34,332,688,0.48,0.49,321,421,0.78,132,386,518,275,173,8,225,333,1378,0.55,15.15
Boris Bakic,21,126,6,20,3,10,0.3,3,10,0.3,0.38,12,22,0.7,5,6,11,3,9,1,13,41,27,0.45,30.46
Boris Dallo,22,198,12,37,1,5,0.2,11,32,0.34,0.34,0,2,0.0,8,13,21,17,5,1,7,23,25,0.33,15.6
Boris Diaw,26,604,66,134,8,30,0.27,58,104,0.56,0.52,23,38,0.62,22,75,97,60,19,19,32,60,163,0.54,17.51
Boris Dzidic,14,184,13,51,8,33,0.24,5,18,0.28,0.33,8,11,0.85,8,22,30,3,6,2,9,27,42,0.38,13.88
Boris Gnjidic,24,569,76,160,33,75,0.44,43,85,0.51,0.58,37,45,0.82,36,32,68,21,26,6,35,83,222,0.62,16.29
Boris Gorenc,30,704,96,193,17,56,0.3,79,137,0.58,0.54,59,93,0.58,23,57,80,54,19,2,39,64,268,0.57,14.29
Boris Savovic,26,355,42,117,9,37,0.24,33,80,0.41,0.4,14,18,0.66,32,52,84,16,3,3,16,37,107,0.43,11.35
Borisa Simanic,27,307,36,65,18,38,0.47,18,27,0.67,0.69,4,6,0.75,8,23,31,11,7,12,16,34,94,0.69,19.13
Bostjan Nachbar,146,2706,436,970,139,369,0.38,297,601,0.49,0.52,271,344,0.8,64,338,402,126,67,33,150,351,1282,0.57,11.8
Bracey Wright,36,1092,173,414,50,154,0.32,123,260,0.47,0.48,109,143,0.76,23,70,93,56,30,5,70,73,505,0.53,12.8
Brad Newley,15,377,42,101,11,33,0.33,31,68,0.46,0.47,17,24,0.71,20,41,61,21,9,10,17,33,112,0.5,13.22
Brad Oleson,150,2888,320,733,160,416,0.38,160,317,0.5,0.55,118,144,0.83,52,174,226,227,75,27,110,268,918,0.58,12.14
Brad Wanamaker,94,2770,413,950,124,341,0.36,289,609,0.47,0.5,320,379,0.83,43,259,302,392,131,8,212,244,1270,0.57,15.95
Bradley Traina,25,473,61,150,29,80,0.36,32,70,0.46,0.5,11,18,0.63,20,38,58,13,17,1,35,58,162,0.51,18.14
Brandon Davies,28,563,104,202,5,13,0.38,99,189,0.52,0.53,55,70,0.79,34,75,109,45,31,16,56,71,268,0.58,19.39
Brandon Jennings,16,314,43,111,11,41,0.27,32,70,0.46,0.44,24,31,0.77,3,22,25,26,19,1,19,37,121,0.49,13.23
Brandon Paul,50,929,126,322,87,220,0.4,39,102,0.38,0.53,91,131,0.7,11,91,102,48,46,7,43,111,430,0.57,10.17
Branimir Longin,33,618,71,163,25,64,0.39,46,99,0.46,0.51,46,70,0.47,27,54,81,26,22,1,31,65,213,0.55,13.79
Branislav Djekic,31,293,24,59,13,34,0.38,11,25,0.44,0.52,17,24,0.72,6,30,36,14,6,3,20,54,78,0.56,22.33
Branko Cvetkovic,9,246,35,79,11,28,0.39,24,51,0.47,0.51,28,38,0.74,5,13,18,7,10,1,19,20,109,0.57,16.56
Branko Lazic,140,2714,194,477,79,238,0.33,115,239,0.48,0.49,73,94,0.77,85,148,233,101,116,9,89,395,540,0.52,14.65
Branko Milisavljevic,4,62,6,14,2,5,0.4,4,9,0.44,0.5,3,5,0.6,1,5,6,4,1,0,4,10,17,0.52,19.8
Braydon Hobbs,18,177,20,47,20,41,0.49,0,6,0.0,0.64,7,8,0.88,2,14,16,48,8,0,16,19,67,0.66,24.05
Brent Petway,56,1063,116,248,55,151,0.36,61,97,0.63,0.58,34,47,0.71,55,145,200,50,21,50,40,160,321,0.6,12.96
Brent Wright,24,677,90,195,4,16,0.25,86,179,0.48,0.47,88,119,0.73,60,106,166,32,27,7,76,81,272,0.55,23.5
Brett Eppehimer,12,391,53,159,24,82,0.29,29,77,0.38,0.41,41,49,0.84,5,14,19,18,12,0,42,21,171,0.47,18.87
Brian Chase,10,299,44,109,20,51,0.39,24,58,0.41,0.5,16,18,0.89,7,22,29,24,15,0,22,31,124,0.53,15.84
Brian Greene,10,197,30,77,13,35,0.37,17,42,0.4,0.47,14,16,0.88,6,24,30,15,10,2,10,21,87,0.52,10.63
Brian Randle,33,900,154,260,8,30,0.27,146,230,0.63,0.61,52,78,0.68,55,104,159,58,43,37,46,115,368,0.63,13.52
Brian Roberts,52,1081,140,341,54,152,0.36,86,189,0.46,0.49,101,110,0.85,13,79,92,90,26,0,64,117,435,0.56,14.12
Brian Sacchetti,18,287,18,46,10,30,0.33,8,16,0.5,0.5,11,16,0.82,12,35,47,18,10,0,9,27,57,0.54,14.51
Briante Weber,8,194,37,70,6,13,0.46,31,57,0.54,0.57,13,17,0.76,7,30,37,21,8,2,22,29,93,0.6,22.11
Brion Rush,22,664,116,276,55,141,0.39,61,135,0.45,0.52,40,50,0.78,22,49,71,48,35,3,53,53,327,0.55,15.1
Britton Johnsen,20,490,77,156,19,61,0.31,58,95,0.61,0.55,49,62,0.79,22,62,84,22,21,7,43,67,222,0.61,19.0
Brock Motum,135,2282,407,811,111,269,0.41,296,542,0.55,0.57,136,172,0.8,129,213,342,68,51,6,107,172,1061,0.6,10.77
Brooks Sales,13,319,49,102,4,17,0.24,45,85,0.53,0.5,17,26,0.65,28,50,78,10,12,3,22,34,119,0.52,16.24
Bruno Cerella,54,522,41,98,14,43,0.33,27,55,0.49,0.49,10,15,0.72,19,40,59,36,23,1,16,72,106,0.51,13.27
Bruno Fitipaldo,16,225,29,65,16,38,0.42,13,27,0.48,0.57,12,14,0.86,1,3,4,38,4,0,22,38,86,0.6,23.62
Bruno Sundov,4,38,5,14,2,5,0.4,3,9,0.33,0.43,2,2,1.0,5,3,8,0,0,0,3,5,14,0.47,16.78
Bryan Bailey,4,84,13,23,4,9,0.44,9,14,0.64,0.65,3,6,0.5,2,4,6,7,2,0,7,10,33,0.64,21.45
Bryant Dunston,168,4308,612,997,4,19,0.21,608,978,0.62,0.62,367,562,0.65,353,534,887,185,134,216,147,474,1595,0.64,10.57
Bryant Smith,16,186,17,41,8,19,0.42,9,22,0.41,0.51,10,15,0.67,10,17,27,5,13,1,11,19,52,0.55,18.77
Bryce Cotton,10,183,29,68,12,32,0.38,17,36,0.47,0.51,10,11,0.91,2,14,16,14,5,0,9,21,80,0.55,11.0
Bryce Taylor,43,1008,114,262,47,106,0.44,67,156,0.43,0.52,52,59,0.86,41,94,135,49,39,5,28,116,327,0.57,8.86
Byron Dinkins,26,767,108,244,36,116,0.31,72,128,0.56,0.52,65,81,0.79,7,69,76,81,36,0,64,59,317,0.57,18.62
Cal Bowdler,27,322,38,73,1,5,0.2,37,68,0.54,0.53,39,58,0.68,25,43,68,3,11,11,17,42,116,0.59,14.72
Caleb Green,34,673,93,214,31,90,0.34,62,124,0.5,0.51,57,88,0.66,38,94,132,26,27,6,51,70,274,0.54,16.79
Calvin Bowman,14,328,49,103,0,2,0.0,49,101,0.49,0.48,24,46,0.52,22,41,63,6,4,12,22,40,122,0.49,15.15
Can Altintig,10,166,15,37,5,15,0.33,10,22,0.45,0.47,7,10,0.7,4,14,18,16,8,1,14,18,42,0.51,25.27
Can Korkmaz,10,79,11,25,6,15,0.4,5,10,0.5,0.56,6,8,0.75,2,4,6,8,2,0,4,10,34,0.6,12.3
Can Maxim Mutaf,3,28,1,6,0,4,0.0,1,2,0.5,0.17,2,2,1.0,1,2,3,1,1,0,3,5,4,0.29,30.36
Caner Topaloglu,9,64,2,12,1,4,0.25,1,8,0.12,0.21,3,4,0.75,2,5,7,6,3,1,1,11,8,0.29,6.78
Carl English,20,454,58,151,37,92,0.4,21,59,0.36,0.51,11,16,0.69,8,43,51,22,8,1,32,50,164,0.52,16.84
Carlos Arroyo,80,2133,321,800,117,337,0.35,204,463,0.44,0.47,152,178,0.87,23,132,155,325,52,3,129,180,911,0.52,12.81
Carlos Cabezas,161,3440,386,842,117,347,0.34,269,495,0.54,0.53,264,332,0.81,91,226,317,279,102,8,249,255,1153,0.58,20.13
Carlos Delfino,37,1160,160,395,50,159,0.31,110,236,0.47,0.47,82,112,0.73,55,184,239,74,62,8,58,105,452,0.51,11.55
Carlos Jimenez,118,2550,214,482,89,227,0.39,125,255,0.49,0.54,193,251,0.75,116,436,552,149,125,30,152,317,710,0.6,20.42
Carlos Suarez,170,3379,271,729,121,408,0.3,150,321,0.47,0.45,200,256,0.77,188,411,599,285,91,21,160,247,863,0.51,15.97
Carlton Myers,38,992,134,356,77,204,0.38,57,152,0.38,0.48,123,150,0.83,17,59,76,77,44,0,75,98,468,0.55,15.09
Casey Jacobsen,95,2602,258,598,152,372,0.41,106,226,0.47,0.56,137,173,0.79,43,189,232,159,62,5,131,183,805,0.6,16.27
Casey Schmidt,12,358,43,90,14,39,0.36,29,51,0.57,0.56,14,15,0.93,6,43,49,16,9,1,13,31,114,0.59,11.86
Cedi Osman,98,1780,228,548,94,264,0.36,134,284,0.47,0.5,110,155,0.65,80,209,289,84,67,14,65,185,660,0.54,9.54
Cedomir Vitkovac,39,643,61,154,17,61,0.28,44,93,0.47,0.45,41,50,0.85,40,84,124,22,19,6,37,89,180,0.51,17.37
Cedric Ferchaud,19,306,34,80,25,62,0.4,9,18,0.5,0.58,3,4,0.75,3,21,24,7,11,1,14,37,96,0.59,14.62
Cedric Simmons,22,242,32,58,0,1,0.0,32,57,0.56,0.55,20,37,0.54,27,40,67,3,3,11,18,35,84,0.57,19.51
Cedrick Banks,12,337,49,116,27,73,0.37,22,43,0.51,0.54,14,17,0.68,9,26,35,20,17,2,29,18,139,0.56,19.02
Cemal Nalga,11,122,12,24,0,1,0.0,12,23,0.52,0.5,5,17,0.29,5,24,29,3,1,2,11,18,29,0.46,25.89
Cenk Akyol,82,1191,113,292,65,170,0.38,48,122,0.39,0.5,53,75,0.6,23,105,128,40,48,5,41,143,344,0.53,11.2
Cesar Bravo,6,52,3,6,0,1,0.0,3,5,0.6,0.5,0,2,0.0,2,3,5,1,2,0,3,12,6,0.44,30.36
Cevher Ozer,37,474,55,150,26,95,0.27,29,55,0.53,0.45,20,24,0.9,16,61,77,17,7,2,19,52,156,0.49,10.58
Chad Austin,14,498,77,219,22,75,0.29,55,144,0.38,0.4,37,44,0.84,19,39,58,20,16,0,36,37,213,0.45,13.12
Charis Giannopoulos,6,23,5,7,3,4,0.75,2,3,0.67,0.93,1,2,0.5,3,2,5,0,1,0,1,4,14,0.89,11.26
Charles Evans,8,133,13,27,2,10,0.2,11,17,0.65,0.52,7,7,1.0,2,6,8,11,6,0,14,13,35,0.58,31.76
Charles Jenkins,160,3596,389,903,149,368,0.4,240,535,0.45,0.51,139,171,0.78,72,235,307,281,201,24,140,426,1066,0.54,12.52
Charles Kahudi,23,492,58,135,23,63,0.37,35,72,0.49,0.51,22,26,0.85,19,48,67,19,11,3,17,55,161,0.55,10.4
Charles Smith,79,2122,363,862,174,498,0.35,189,364,0.52,0.52,119,159,0.71,39,169,208,140,157,39,112,176,1019,0.55,10.73
Charlie Bell,14,385,65,158,18,68,0.26,47,90,0.52,0.47,35,47,0.79,6,24,30,19,17,4,32,37,183,0.51,15.19
Chase Budinger,29,548,78,159,19,58,0.33,59,101,0.58,0.55,23,27,0.85,38,72,110,35,18,4,26,49,198,0.58,13.21
Chasson Randle,23,175,22,50,9,20,0.45,13,30,0.43,0.53,6,8,0.75,2,9,11,22,5,1,7,28,59,0.55,11.57
Chevon Troutman,20,342,57,102,4,21,0.19,53,81,0.65,0.58,18,26,0.69,28,49,77,13,12,2,13,38,136,0.6,10.28
Cheyne Gadson,3,56,8,19,0,4,0.0,8,15,0.53,0.42,5,6,0.83,1,3,4,4,4,1,7,4,21,0.49,24.44
Chris Booker,12,154,18,40,0,5,0.0,18,35,0.51,0.45,7,11,0.64,14,12,26,6,7,7,9,17,43,0.48,16.72
Chris Carr,9,158,25,69,11,27,0.41,14,42,0.33,0.44,7,11,0.64,5,9,14,16,6,0,16,24,68,0.46,17.81
Chris Carrawell,6,111,11,34,0,2,0.0,11,32,0.34,0.32,11,15,0.73,4,8,12,3,2,3,2,6,33,0.41,4.69
Chris Corchiani,34,514,39,98,15,51,0.29,24,47,0.51,0.47,65,83,0.78,16,28,44,46,41,0,31,66,158,0.59,18.73
Chris Ensminger,12,200,31,49,1,1,1.0,30,48,0.62,0.64,19,32,0.59,10,31,41,10,2,0,18,38,82,0.65,22.2
Chris Evans,12,226,45,96,14,33,0.42,31,63,0.49,0.54,19,22,0.86,14,17,31,13,6,1,12,22,123,0.58,10.2
Chris Gatling,6,139,28,49,2,7,0.29,26,42,0.62,0.59,19,35,0.54,10,21,31,6,3,3,8,17,77,0.6,11.05
Chris Hill,19,441,69,179,25,85,0.29,44,94,0.47,0.46,18,27,0.64,21,55,76,33,16,0,35,49,181,0.47,15.49
Chris Kramer,16,307,33,75,10,29,0.34,23,46,0.5,0.51,6,12,0.5,7,26,33,46,6,2,19,37,82,0.51,19.14
Chris Singleton,161,4224,481,1121,216,518,0.42,265,603,0.44,0.53,327,430,0.77,212,597,809,164,183,108,196,452,1505,0.57,13.01
Chris Warren,44,1348,217,487,74,185,0.4,143,302,0.47,0.52,114,152,0.74,54,148,202,71,51,11,90,105,622,0.56,13.98
Chris Williams,14,487,103,213,3,23,0.13,100,190,0.53,0.49,56,81,0.69,23,73,96,38,39,10,40,39,265,0.53,13.86
Chris Wright,8,168,30,50,2,7,0.29,28,43,0.65,0.62,9,12,0.75,13,22,35,2,4,8,9,20,71,0.64,14.0
Christian Burns,14,44,4,10,0,1,0.0,4,9,0.44,0.4,6,6,1.0,5,6,11,1,0,2,2,16,14,0.55,13.66
Christian Dalmau,33,823,127,297,43,134,0.32,84,163,0.52,0.5,41,72,0.57,15,56,71,84,49,3,78,103,338,0.51,19.18
Christian Drejer,15,179,22,50,7,18,0.39,15,32,0.47,0.51,8,10,0.69,5,15,20,7,4,2,12,30,59,0.54,18.07
Christian Eyenga,20,536,82,171,6,24,0.25,76,147,0.52,0.5,30,41,0.73,19,68,87,37,18,18,31,42,200,0.53,14.09
Christian Maraker,5,52,7,20,0,3,0.0,7,17,0.41,0.35,3,4,0.75,8,11,19,1,1,2,2,6,17,0.39,8.42
Christophe Beghin,23,562,78,175,2,9,0.22,76,166,0.46,0.45,49,77,0.63,45,55,100,12,13,8,35,69,207,0.5,14.35
Christophe Leonard,8,113,15,25,2,3,0.67,13,22,0.59,0.64,4,4,1.0,9,12,21,3,2,1,7,14,36,0.67,20.73
Christos Harissis,91,1466,167,425,73,228,0.32,94,197,0.48,0.48,78,110,0.72,36,102,138,136,59,5,93,218,485,0.51,16.42
Christos Tapoutos,33,619,69,166,14,45,0.31,55,121,0.45,0.46,30,36,0.81,12,67,79,38,9,6,40,55,182,0.5,18.03
Chuck Eidson,78,2196,273,654,85,228,0.37,188,426,0.44,0.48,182,238,0.76,82,239,321,221,141,12,132,159,813,0.54,14.82
Chuck Kornegay,14,272,35,58,0,1,0.0,35,57,0.61,0.6,16,25,0.64,26,42,68,8,6,14,22,33,86,0.62,24.18
Clarence Gilbert,11,304,38,101,26,68,0.38,12,33,0.36,0.5,11,17,0.65,3,21,24,19,16,0,14,25,113,0.52,11.43
Claude Marquis,10,163,27,55,0,1,0.0,27,54,0.5,0.49,11,21,0.52,21,15,36,2,4,2,16,28,65,0.51,19.94
Claudio Coldebella,23,482,32,82,16,42,0.38,16,40,0.4,0.49,33,40,0.8,8,49,57,40,23,2,19,64,113,0.57,16.02
Claudio Pilutti,26,429,37,82,21,43,0.49,16,39,0.41,0.58,9,17,0.51,10,36,46,18,23,1,18,48,104,0.58,16.75
Clay Tucker,23,538,76,211,25,86,0.29,51,125,0.41,0.42,22,29,0.76,6,46,52,39,12,5,29,49,199,0.44,11.47
Clevin Hannah,18,368,53,126,17,56,0.3,36,70,0.51,0.49,44,48,0.92,6,23,29,67,19,0,44,46,167,0.57,23.02
Cliff Hammonds,25,571,69,151,26,74,0.35,43,77,0.56,0.54,17,22,0.79,3,39,42,62,16,8,32,67,181,0.56,16.61
Clint Harrison,26,695,87,207,36,106,0.34,51,101,0.5,0.51,66,82,0.8,16,45,61,44,45,1,47,83,276,0.57,16.2
Colton Iverson,50,924,122,208,0,2,0.0,122,206,0.59,0.59,71,118,0.61,113,152,265,39,21,29,53,122,315,0.61,16.94
Corey Albano,27,525,88,157,8,26,0.31,80,131,0.61,0.59,48,73,0.68,31,71,102,23,22,3,43,86,232,0.61,18.52
Cory Alexander,10,295,40,92,14,45,0.31,26,47,0.55,0.51,27,42,0.64,4,18,22,27,14,3,21,34,121,0.55,15.97
Cory Higgins,152,3574,625,1258,180,392,0.46,445,866,0.51,0.57,415,490,0.84,64,272,336,276,106,26,225,371,1845,0.63,13.25
Cory Jefferson,18,213,24,63,7,28,0.25,17,35,0.49,0.44,7,13,0.29,10,19,29,5,1,2,5,27,62,0.45,6.78
Coty Clarke,43,941,106,244,23,57,0.4,83,187,0.44,0.48,48,59,0.82,41,142,183,48,35,9,46,97,283,0.52,14.56
Courtney Eldridge,4,54,2,11,1,3,0.33,1,8,0.12,0.23,3,6,0.5,0,1,1,5,0,0,6,8,8,0.29,30.55
Crawford Palmer,13,215,27,63,0,1,0.0,27,62,0.44,0.43,14,16,0.88,11,41,52,8,4,9,21,41,68,0.49,23.07
Cuneyt Erden,35,548,42,122,33,90,0.37,9,32,0.28,0.48,14,19,0.76,11,33,44,43,31,0,31,71,131,0.5,19.21
Curtis Borchardt,1,32,7,11,0,1,0.0,7,10,0.7,0.64,6,11,0.55,3,4,7,2,0,2,2,2,20,0.63,11.21
Curtis Jerrells,133,2955,460,1092,186,527,0.35,274,565,0.48,0.51,189,243,0.78,36,232,268,319,91,10,198,193,1295,0.54,14.17
Curtis McCants,26,645,109,224,22,61,0.36,87,163,0.53,0.54,52,64,0.9,7,34,41,77,21,1,49,53,292,0.58,16.27
Curtis Millage,4,42,4,10,0,2,0.0,4,8,0.5,0.4,2,2,1.0,2,2,4,3,4,0,3,4,10,0.46,21.61
D'or Fischer,52,1236,208,308,3,6,0.5,205,302,0.68,0.68,86,109,0.79,92,220,312,75,24,79,63,143,505,0.71,15.04
D.J. Seeley,26,526,59,137,24,62,0.39,35,75,0.47,0.52,47,53,0.89,15,37,52,67,13,5,45,60,189,0.59,21.92
D.J. Strawberry,57,1187,147,387,54,175,0.31,93,212,0.44,0.45,75,107,0.69,31,100,131,107,50,12,76,106,423,0.49,14.9
DaJuan Summers,10,278,46,108,6,27,0.22,40,81,0.49,0.45,25,31,0.81,14,32,46,10,15,6,14,15,123,0.51,10.32
DaShaun Wood,23,561,82,175,32,74,0.43,50,101,0.5,0.56,30,38,0.79,6,30,36,58,14,2,41,47,226,0.59,17.62
Daequan Cook,4,77,12,30,7,17,0.41,5,13,0.38,0.52,5,6,0.83,2,5,7,4,3,0,8,8,36,0.55,19.69
Dainius Adomaitis,28,824,85,174,35,70,0.5,50,104,0.48,0.59,61,82,0.76,23,82,105,38,18,5,42,84,266,0.63,16.66
Dainius Salenga,136,3505,425,964,134,420,0.32,291,544,0.53,0.51,179,242,0.76,107,228,335,234,142,29,162,228,1163,0.54,13.14
Dairis Bertans,103,1750,205,459,139,301,0.46,66,158,0.42,0.6,92,110,0.83,23,60,83,120,39,4,55,188,641,0.63,9.78
Dajuan Wagner,6,125,20,57,6,10,0.6,14,47,0.3,0.4,4,6,0.67,2,13,15,5,4,0,10,14,50,0.42,14.36
Dalibor Bagaric,39,791,127,215,1,4,0.25,126,211,0.6,0.59,66,108,0.59,51,149,200,33,35,32,69,101,321,0.61,20.81
Damian Kulig,10,253,58,103,17,36,0.47,41,67,0.61,0.65,19,30,0.63,12,43,55,15,6,11,20,38,152,0.65,14.68
Damir Markota,82,1773,209,496,65,227,0.29,144,269,0.54,0.49,93,127,0.73,105,258,363,93,43,15,119,121,576,0.52,17.74
Damir Mrsic,58,1188,148,326,117,277,0.42,31,49,0.63,0.63,37,45,0.88,11,48,59,79,31,0,58,91,450,0.65,14.36
Damir Mulaomerovic,46,1097,146,341,50,133,0.38,96,208,0.46,0.5,109,143,0.77,14,58,72,101,43,0,112,110,451,0.56,21.71
Damir Rancic,27,545,52,148,30,98,0.31,22,50,0.44,0.45,8,11,0.81,7,36,43,33,16,0,20,58,142,0.46,11.57
Damjan Rudez,21,306,34,84,17,43,0.4,17,41,0.41,0.51,3,4,0.83,9,30,39,19,3,1,19,41,88,0.51,18.14
Dani Garcia,13,78,7,23,2,8,0.25,5,15,0.33,0.35,1,2,0.5,2,12,14,5,0,3,4,12,17,0.36,14.35
Daniel Diez,71,942,101,207,35,98,0.36,66,109,0.61,0.57,21,30,0.6,46,106,152,36,24,2,28,54,258,0.59,11.28
Daniel Ewing,55,1584,226,557,88,239,0.37,138,318,0.43,0.48,111,140,0.8,26,99,125,145,69,11,129,124,651,0.53,17.26
Daniel Hackett,192,4289,522,1241,166,471,0.35,356,770,0.46,0.49,393,515,0.76,63,442,505,578,156,29,271,518,1603,0.55,15.59
Daniel Hain,9,116,3,12,0,4,0.0,3,8,0.38,0.25,1,4,0.25,7,6,13,3,0,1,11,21,7,0.25,44.43
Daniel Miller,13,244,23,66,12,38,0.32,11,28,0.39,0.44,10,15,0.67,5,16,21,7,8,0,16,29,68,0.47,18.06
Daniel Santiago,57,970,184,301,0,4,0.0,184,297,0.62,0.61,111,155,0.74,67,140,207,28,22,41,81,155,479,0.65,17.99
Daniel Schmidt,12,96,5,17,1,7,0.14,4,10,0.4,0.32,1,2,0.5,1,5,6,14,2,0,7,20,12,0.34,28.14
Daniel Strauch,3,12,1,5,0,4,0.0,1,1,1.0,0.2,1,1,1.0,0,0,0,0,0,0,0,1,3,0.28,0.0
Daniel Theis,54,1062,198,347,30,75,0.4,168,272,0.62,0.61,81,110,0.74,82,160,242,35,31,42,57,170,507,0.64,12.6
Daniele Cavaliero,13,163,13,36,9,24,0.38,4,12,0.33,0.49,11,14,0.79,1,9,10,17,9,0,11,22,46,0.55,20.69
Daniele Cinciarini,16,146,15,30,7,13,0.54,8,17,0.47,0.62,8,9,0.93,5,7,12,5,7,0,13,22,45,0.66,27.68
Danilo Andusic,25,252,26,83,13,55,0.24,13,28,0.46,0.39,24,29,0.87,4,18,22,17,8,0,19,24,89,0.46,16.56
Danilo Barthel,57,1370,169,341,40,114,0.35,129,227,0.57,0.55,79,109,0.73,56,168,224,94,20,10,76,121,457,0.59,16.35
Danilo Gallinari,18,547,76,183,22,74,0.3,54,109,0.5,0.48,105,137,0.77,25,52,77,27,21,7,27,47,279,0.57,9.99
Danilo Nikolic,26,370,52,106,24,59,0.41,28,47,0.6,0.6,12,20,0.6,25,36,61,10,7,7,10,34,140,0.61,8.01
Danny Green,7,199,29,75,8,32,0.25,21,43,0.49,0.44,14,16,0.88,9,19,28,13,7,4,17,16,80,0.49,17.16
Danny Lewis,1,29,3,7,2,4,0.5,1,3,0.33,0.57,3,4,0.75,0,2,2,5,1,0,3,2,11,0.63,25.51
Dante Calabria,25,650,72,198,44,133,0.33,28,65,0.43,0.47,44,55,0.87,19,79,98,50,38,3,34,58,232,0.52,13.27
Danya Abrams,10,241,35,87,3,18,0.17,32,69,0.46,0.42,38,58,0.66,13,43,56,13,8,7,27,40,111,0.49,19.35
Dario Saric,55,1257,197,431,49,140,0.35,148,291,0.51,0.51,112,143,0.72,85,243,328,99,33,24,99,121,555,0.56,16.7
Darius Adams,43,1053,196,479,100,279,0.36,96,200,0.48,0.51,62,74,0.85,11,85,96,156,53,4,115,75,554,0.54,18.35
Darius Johnson-Odom,12,167,14,48,8,19,0.42,6,29,0.21,0.38,13,20,0.65,5,12,17,18,4,1,7,18,49,0.43,10.97
Darius Maskoliunas,19,319,14,40,8,25,0.32,6,15,0.4,0.45,5,8,0.62,5,20,25,11,7,0,10,47,41,0.47,18.68
Darius Miller,54,1409,210,452,93,228,0.41,117,224,0.52,0.57,78,87,0.9,16,124,140,101,25,26,77,153,591,0.6,13.57
Darius Silinskis,22,189,12,40,0,2,0.0,12,38,0.32,0.3,16,20,0.81,16,18,34,4,2,9,10,23,40,0.41,17.01
Darius Songaila,18,389,87,183,6,21,0.29,81,162,0.5,0.49,50,59,0.85,24,46,70,20,10,3,26,61,230,0.55,11.07
Darius Washington,25,627,105,220,15,45,0.33,90,175,0.51,0.51,75,91,0.82,24,49,73,59,29,3,58,61,300,0.58,18.24
Darjus Lavrinovic,118,2444,424,822,76,222,0.34,348,600,0.58,0.56,248,330,0.79,167,395,562,133,83,123,193,303,1172,0.61,16.64
Darko Krunic,21,381,64,132,26,58,0.45,38,74,0.51,0.58,48,50,0.98,7,17,24,35,11,1,18,36,202,0.66,10.47
Darrel Mitchell,7,58,5,10,3,5,0.6,2,5,0.4,0.65,4,4,1.0,0,2,2,4,1,0,5,11,17,0.72,29.83
Darren Fenn,14,342,50,118,20,63,0.32,30,55,0.55,0.51,15,23,0.65,12,49,61,7,5,8,20,34,135,0.53,13.5
Darren McLinton,10,180,25,57,13,32,0.41,12,25,0.48,0.55,13,14,0.92,0,4,4,11,5,0,10,13,76,0.6,13.67
Darren Phillip,25,398,55,90,1,4,0.25,54,86,0.63,0.62,39,57,0.69,46,42,88,17,15,3,21,48,150,0.65,15.43
Darrun Hilliard,61,1245,200,487,95,257,0.37,105,230,0.46,0.51,112,143,0.79,17,146,163,71,38,5,88,142,607,0.55,13.79
Darryl Middleton,22,466,74,110,0,1,0.0,74,109,0.68,0.67,59,90,0.66,30,40,70,13,11,4,36,74,207,0.69,19.4
David Andersen,194,4350,769,1553,93,225,0.41,676,1328,0.51,0.53,405,505,0.8,261,751,1012,156,108,72,265,438,2036,0.57,12.99
David Arigbabu,9,119,16,31,0,1,0.0,16,30,0.53,0.52,4,8,0.5,9,22,31,6,3,2,8,17,36,0.52,18.81
David Berbois,8,139,20,46,8,24,0.33,12,22,0.55,0.52,12,15,0.8,4,9,13,14,4,0,25,25,60,0.57,32.22
David Bluthenthal,181,3997,599,1312,288,701,0.41,311,611,0.51,0.57,165,198,0.8,138,364,502,138,98,10,163,384,1651,0.59,10.43
David Brkic,22,268,27,55,17,32,0.53,10,23,0.43,0.65,7,11,0.62,11,33,44,4,4,4,17,28,78,0.65,22.12
David Cournooh,8,67,5,16,2,6,0.33,3,10,0.3,0.38,5,6,0.83,1,5,6,2,2,0,2,8,17,0.46,9.69
David Desy,20,434,39,95,15,48,0.31,24,47,0.51,0.49,25,30,0.82,3,19,22,24,10,0,30,52,118,0.55,21.71
David Evans,4,43,2,9,1,3,0.33,1,6,0.17,0.28,6,6,1.0,1,2,3,3,4,0,5,8,11,0.47,30.05
David Frigout,24,465,79,124,0,3,0.0,79,121,0.65,0.64,18,31,0.55,30,55,85,11,12,18,25,79,176,0.64,15.37
David Hawkins,79,2259,324,780,82,279,0.29,242,501,0.48,0.47,247,308,0.81,78,162,240,177,151,12,129,238,977,0.53,12.35
David Jackson,4,41,2,10,1,4,0.25,1,6,0.17,0.25,2,4,0.5,0,3,3,2,0,0,1,3,7,0.3,7.84
David Jelinek,29,481,63,126,28,65,0.43,35,61,0.57,0.61,17,21,0.9,6,27,33,34,17,0,27,60,171,0.63,16.64
David Lighty,39,875,136,300,38,110,0.35,98,190,0.52,0.52,48,65,0.71,32,68,100,67,32,8,43,72,358,0.54,11.57
David Logan,120,3177,513,1206,215,598,0.36,298,608,0.49,0.51,141,200,0.72,37,200,237,258,176,19,211,183,1382,0.53,14.02
David Moss,115,2800,313,711,134,349,0.38,179,362,0.49,0.53,111,135,0.82,98,266,364,162,108,20,122,334,871,0.57,13.67
David Navarro,7,31,3,3,1,1,1.0,2,2,1.0,1.17,2,2,1.0,2,3,5,1,1,0,4,4,9,1.16,50.76
David Rivers,11,289,35,96,16,46,0.35,19,50,0.38,0.45,20,27,0.74,8,17,25,24,18,0,22,36,106,0.49,16.94
David Vanterpool,75,2055,263,605,40,141,0.28,223,464,0.48,0.47,269,333,0.82,95,232,327,250,157,3,178,218,835,0.56,19.15
Davide Bonora,40,568,29,69,6,32,0.19,23,37,0.62,0.46,35,47,0.7,6,32,38,29,27,2,15,66,99,0.55,14.33
Davide Lamma,19,125,7,22,5,17,0.29,2,5,0.4,0.43,4,10,0.4,1,6,7,15,8,1,9,19,23,0.44,25.42
Davide Pascolo,33,459,79,148,3,25,0.12,76,123,0.62,0.54,20,26,0.71,40,45,85,22,20,9,15,67,181,0.57,8.6
Davis Bertans,57,1148,149,376,98,255,0.38,51,121,0.42,0.53,61,74,0.85,24,113,137,46,22,20,54,155,457,0.56,11.67
Davor Kus,148,3243,328,773,133,354,0.38,195,419,0.47,0.51,336,403,0.83,42,151,193,247,86,10,207,274,1125,0.59,17.89
Davor Marcelic,74,1912,227,579,117,361,0.32,110,218,0.5,0.49,79,102,0.75,59,157,216,89,62,5,88,145,650,0.52,12.36
Davor Pejcinovic,13,337,43,101,0,2,0.0,43,99,0.43,0.43,30,54,0.53,27,53,80,19,16,27,20,42,116,0.46,13.82
Davor Tomic,8,48,1,12,0,2,0.0,1,10,0.1,0.08,4,7,0.57,7,5,12,2,3,0,6,1,6,0.2,28.46
DeJuan Collins,72,1869,248,583,53,186,0.28,195,397,0.49,0.47,230,288,0.8,54,166,220,224,80,8,177,180,779,0.55,19.96
DeMarcus Nelson,69,1312,183,427,28,107,0.26,155,320,0.48,0.46,63,97,0.65,48,120,168,153,49,10,108,137,457,0.49,18.7
Deandre Kane,55,1345,166,352,33,109,0.3,133,243,0.55,0.52,56,120,0.46,75,140,215,127,53,12,68,123,421,0.52,14.38
Dee Bost,39,817,99,260,42,147,0.29,57,113,0.5,0.46,39,49,0.85,17,58,75,112,37,1,47,87,279,0.5,14.3
Dee Brown,5,92,12,20,5,8,0.62,7,12,0.58,0.72,2,3,0.67,1,6,7,4,5,1,6,9,31,0.73,21.96
Deividas Dulkys,9,91,7,24,2,11,0.18,5,13,0.38,0.33,5,6,0.83,0,7,7,6,4,0,5,17,21,0.39,15.8
Deividas Gailius,10,269,54,115,24,59,0.41,30,56,0.54,0.57,15,25,0.6,9,39,48,25,13,0,21,25,147,0.58,14.29
Dejan Bodiroga,100,3118,552,1012,61,160,0.38,491,852,0.58,0.58,443,559,0.79,87,361,448,205,91,5,191,230,1608,0.64,13.18
Dejan Borovnjak,30,253,27,52,0,4,0.0,27,48,0.56,0.52,16,24,0.69,22,42,64,7,5,7,22,45,70,0.56,26.02
Dejan Davidovac,48,826,99,201,37,93,0.4,62,108,0.57,0.58,69,88,0.78,35,82,117,42,35,12,38,94,304,0.63,13.68
Dejan Jovanovski,8,206,28,69,15,41,0.37,13,28,0.46,0.51,14,18,0.78,5,16,21,7,6,1,11,29,85,0.55,12.51
Dejan Koturovic,18,418,76,137,1,4,0.25,75,133,0.56,0.56,37,57,0.65,31,71,102,12,8,25,44,66,190,0.59,21.35
Dejan Milojevic,51,1409,213,395,12,56,0.21,201,339,0.59,0.55,174,263,0.57,159,208,367,86,89,8,136,171,612,0.6,21.03
Dejan Musli,23,336,51,102,0,1,0.0,51,101,0.5,0.5,21,39,0.54,26,47,73,8,7,3,19,32,123,0.52,13.75
Dejan Radonjic,23,425,49,113,34,89,0.38,15,24,0.62,0.58,27,36,0.73,6,21,27,25,11,1,15,57,159,0.62,10.43
Dejan Tomasevic,29,941,186,309,0,5,0.0,186,304,0.61,0.6,93,175,0.51,121,165,286,103,60,16,83,70,465,0.6,17.7
Delonte Holland,7,223,51,104,9,23,0.39,42,81,0.52,0.53,25,32,0.78,18,21,39,7,12,2,16,18,136,0.58,11.93
Demarco Johnson,26,809,137,305,1,8,0.12,136,297,0.46,0.45,97,134,0.71,60,114,174,19,34,8,46,85,372,0.51,11.22
Demetris Nichols,82,1099,126,266,55,129,0.43,71,137,0.52,0.58,32,40,0.79,36,126,162,35,37,32,52,132,339,0.6,15.49
Demond Greene,11,298,32,77,22,56,0.39,10,21,0.48,0.56,15,15,1.0,1,16,17,15,13,0,20,28,101,0.6,19.31
Demond Mallet,61,1832,293,668,139,379,0.37,154,289,0.53,0.54,102,132,0.82,23,109,132,166,74,1,124,163,827,0.57,14.59
Deni Avdija,34,422,53,121,18,57,0.32,35,64,0.55,0.51,12,20,0.78,19,61,80,32,11,6,20,59,136,0.52,13.35
Denis Marconato,133,2511,340,544,5,17,0.29,335,527,0.64,0.63,160,220,0.73,199,445,644,91,108,79,139,346,845,0.66,17.83
Deon Thomas,42,592,98,177,0,3,0.0,98,174,0.56,0.55,79,97,0.81,42,77,119,27,20,15,33,142,275,0.63,13.06
Deon Thompson,81,1710,287,580,2,18,0.11,285,562,0.51,0.5,114,171,0.64,151,206,357,57,47,43,98,176,690,0.53,13.01
Derek Hamilton,10,386,77,133,7,19,0.37,70,114,0.61,0.61,57,69,0.83,22,55,77,28,23,12,24,35,218,0.67,12.81
Derek Hood,10,217,28,72,0,3,0.0,28,69,0.41,0.39,11,19,0.58,23,37,60,12,9,1,21,37,67,0.42,20.72
Derrick Alston,14,393,77,151,0,1,0.0,77,150,0.51,0.51,36,65,0.55,29,51,80,15,13,12,33,43,190,0.53,15.52
Derrick Brown,107,2719,454,934,46,144,0.32,408,790,0.52,0.51,200,277,0.73,143,342,485,183,93,44,144,175,1154,0.55,12.0
Derrick Byars,18,369,46,100,20,43,0.47,26,57,0.46,0.56,8,13,0.62,14,39,53,12,12,0,23,36,120,0.57,17.87
Derrick Dial,17,558,90,198,24,72,0.33,66,126,0.52,0.52,33,61,0.54,25,60,85,36,20,5,33,35,237,0.53,12.8
Derrick Lewis,12,156,14,40,4,15,0.27,10,25,0.4,0.4,8,11,0.73,5,20,25,8,11,4,5,28,40,0.45,10.03
Derrick Phelps,32,899,110,252,34,88,0.39,76,164,0.46,0.5,75,96,0.78,23,81,104,105,42,3,70,67,329,0.56,19.22
Derrick Sharp,185,3343,357,779,217,506,0.43,140,273,0.51,0.6,223,251,0.84,58,181,239,168,160,4,137,465,1154,0.65,13.35
Derrick Taylor,7,221,34,69,9,21,0.43,25,48,0.52,0.56,19,22,0.86,4,14,18,21,11,0,12,21,96,0.61,13.23
Derrick Williams,57,1486,240,508,80,226,0.35,160,282,0.57,0.55,144,194,0.73,56,174,230,52,48,23,72,82,704,0.59,10.82
Derwin Kitchen,9,106,11,21,1,6,0.17,10,15,0.67,0.55,10,16,0.62,4,21,25,5,3,0,12,13,33,0.59,29.97
Derya Yannier,5,25,2,4,1,2,0.5,1,2,0.5,0.62,2,2,1.0,1,3,4,1,1,0,1,5,7,0.72,17.01
Deshaun Thomas,161,3469,610,1308,178,490,0.36,432,818,0.53,0.53,198,272,0.73,183,310,493,106,81,24,137,219,1596,0.56,8.76
Desmon Farmer,6,98,15,39,4,19,0.21,11,20,0.55,0.44,8,11,0.73,2,8,10,2,3,0,5,9,42,0.48,10.24
Devin Booker,44,955,188,324,23,53,0.43,165,271,0.61,0.62,68,85,0.73,72,117,189,58,32,12,60,95,467,0.65,14.24
Devin Brown,1,16,3,7,0,2,0.0,3,5,0.6,0.43,1,3,0.33,1,1,2,1,1,0,2,3,7,0.42,19.38
Devin Davis,12,298,32,72,0,1,0.0,32,71,0.45,0.44,27,35,0.77,29,43,72,15,11,2,23,37,91,0.52,20.83
Devin Green,5,178,22,59,4,13,0.31,18,46,0.39,0.41,14,23,0.61,4,18,22,12,14,3,15,17,62,0.45,17.83
Devin Smith,150,4208,590,1341,226,629,0.36,364,712,0.51,0.52,190,228,0.82,154,605,759,224,102,81,196,408,1596,0.55,11.97
Devon Van Oostrum,10,72,4,18,1,11,0.09,3,7,0.43,0.25,3,6,0.5,3,8,11,6,2,0,6,10,12,0.29,22.52
Dewarick Spencer,20,589,107,249,50,121,0.41,57,128,0.45,0.53,54,66,0.82,15,47,62,37,20,4,47,54,318,0.57,14.46
Deyan Ivanov,10,199,25,54,2,10,0.2,23,44,0.52,0.48,16,18,0.89,20,26,46,7,7,2,9,13,68,0.55,12.69
Dickey Simpkins,5,93,13,28,1,4,0.25,12,24,0.5,0.48,6,14,0.43,9,19,28,3,2,1,7,8,33,0.48,17.01
Didier Gadou,12,126,7,17,4,11,0.36,3,6,0.5,0.53,7,7,1.0,3,12,15,13,5,1,11,23,25,0.62,35.39
Diego Fajardo,12,220,29,65,5,11,0.45,24,54,0.44,0.48,29,38,0.76,21,31,52,9,6,2,18,37,92,0.56,18.05
Diego Flaccadori,22,188,16,45,2,14,0.14,14,31,0.45,0.38,8,11,0.73,3,9,12,14,3,2,17,21,42,0.42,25.43
Dimitri Sokolov,10,222,31,44,0,1,0.0,31,43,0.72,0.7,23,40,0.57,18,36,54,5,3,7,14,33,85,0.69,18.52
Dimitrios Agravanis,79,892,97,270,28,130,0.22,69,140,0.49,0.41,47,69,0.68,62,126,188,21,26,21,29,163,269,0.45,8.8
Dimitrios Katsivelis,46,344,21,52,11,26,0.42,10,26,0.38,0.51,5,10,0.6,5,26,31,26,8,4,21,48,58,0.51,27.13
Dimitrios Misiakos,10,75,3,11,0,3,0.0,3,8,0.38,0.27,3,6,0.5,1,5,6,2,1,1,2,13,9,0.33,12.79
Dimitrios Papanikolaou,76,999,128,270,25,75,0.33,103,195,0.53,0.52,92,151,0.69,50,123,173,45,44,14,53,138,373,0.55,13.61
Dimitrios Tsaldaris,36,784,86,200,40,109,0.37,46,91,0.51,0.53,24,33,0.66,12,51,63,47,26,1,51,69,236,0.55,19.21
Dimitris Diamantidis,278,7965,744,1682,372,992,0.38,372,690,0.54,0.55,635,799,0.79,175,794,969,1250,434,118,662,652,2495,0.61,24.56
Dimitriy Khvostov,58,952,69,200,27,101,0.27,42,99,0.42,0.41,44,58,0.76,13,43,56,136,18,0,72,122,209,0.46,24.2
Dimos Dikoudis,130,2794,499,928,47,130,0.36,452,798,0.57,0.56,271,431,0.65,234,394,628,77,87,28,192,347,1316,0.59,14.66
Dino Muric,18,252,27,71,2,8,0.25,25,63,0.4,0.39,10,14,0.83,21,23,44,1,8,2,10,25,66,0.43,11.47
Dinos Mitoglou,59,773,109,218,13,54,0.24,96,164,0.59,0.53,49,72,0.6,83,103,186,23,33,11,33,108,280,0.56,11.67
Dion Glover,14,333,44,112,9,37,0.24,35,75,0.47,0.43,23,37,0.62,9,36,45,21,14,5,24,34,120,0.47,15.76
Dionte Christmas,13,198,28,58,20,36,0.56,8,22,0.36,0.66,8,11,0.73,2,12,14,9,6,2,12,26,84,0.67,16.03
Djoko Salic,8,16,2,6,0,1,0.0,2,5,0.4,0.33,1,4,0.25,2,0,2,2,1,0,1,6,5,0.32,11.42
Djuro Ostojic,14,468,65,105,1,2,0.5,64,103,0.62,0.62,55,92,0.6,56,45,101,25,12,6,38,50,186,0.64,20.71
Dmitry Domani,41,962,72,147,14,44,0.32,58,103,0.56,0.54,70,110,0.64,26,71,97,53,43,4,46,104,228,0.58,19.06
Dmitry Flis,17,207,21,59,2,13,0.15,19,46,0.41,0.37,14,27,0.52,15,33,48,5,7,6,16,32,58,0.41,18.42
Dmitry Golovin,16,111,2,7,2,4,0.5,0,3,0.0,0.43,1,4,0.25,3,5,8,15,2,1,5,13,7,0.4,36.34
Dmitry Kulagin,35,273,38,96,12,42,0.29,26,54,0.48,0.46,8,11,0.4,5,34,39,29,7,1,23,39,96,0.48,18.57
Dogus Balbay,174,1735,129,314,28,93,0.3,101,221,0.46,0.46,17,31,0.5,91,128,219,175,97,19,70,264,303,0.46,17.6
Dogus Ozdemiroglu,28,323,32,80,12,43,0.28,20,37,0.54,0.48,17,25,0.68,9,25,34,33,24,1,24,63,93,0.51,20.87
Domen Lorbek,14,440,42,119,21,57,0.37,21,62,0.34,0.44,21,27,0.78,13,28,41,19,18,1,17,33,126,0.48,11.5
Domenico Morena,4,44,5,9,2,5,0.4,3,4,0.75,0.67,1,2,0.5,2,6,8,0,3,0,1,9,13,0.66,9.19
Dominic Waters,30,364,44,93,6,22,0.27,38,71,0.54,0.51,14,15,0.96,4,20,24,63,5,0,38,64,108,0.54,27.62
Dominik Tomczyk,38,978,136,281,61,123,0.5,75,158,0.47,0.59,81,101,0.8,51,133,184,31,29,22,46,105,414,0.64,12.38
Donatas Motiejunas,13,334,49,115,14,48,0.29,35,67,0.52,0.49,17,35,0.73,19,68,87,9,6,8,26,33,129,0.49,16.62
Donatas Slanina,60,1683,263,588,119,305,0.39,144,283,0.51,0.55,135,155,0.87,29,111,140,92,49,6,91,155,780,0.59,12.18
Donatas Zavackas,20,508,63,127,36,75,0.48,27,52,0.52,0.64,37,47,0.79,31,52,83,29,16,2,35,55,199,0.67,19.16
Donnie McGrath,21,440,43,104,23,61,0.38,20,43,0.47,0.52,14,15,0.92,2,26,28,30,16,1,30,30,123,0.56,21.34
Dontaye Draper,133,2237,190,503,93,279,0.33,97,224,0.43,0.47,82,101,0.81,34,160,194,241,118,13,121,256,555,0.51,18.1
Dorell Wright,27,697,106,252,54,128,0.42,52,124,0.42,0.53,48,55,0.87,24,123,147,45,24,12,27,49,314,0.57,8.91
Doremus Bennerman,11,216,23,48,12,28,0.43,11,20,0.55,0.6,13,14,0.93,2,7,9,11,4,0,15,18,71,0.66,21.69
Doron Perkins,55,1166,137,324,37,128,0.29,100,196,0.51,0.48,103,158,0.72,49,192,241,158,64,14,89,141,414,0.53,18.44
Doron Sheffer,5,33,4,9,2,4,0.5,2,5,0.4,0.56,1,2,0.5,1,4,5,5,4,0,3,6,11,0.56,23.29
Doug Overton,2,36,6,14,4,9,0.44,2,5,0.4,0.57,1,1,1.0,0,3,3,3,0,0,2,4,17,0.59,12.17
Dragan Bender,7,74,6,18,2,8,0.25,4,10,0.4,0.39,1,2,0.5,2,8,10,4,2,3,4,8,15,0.4,17.48
Dragan Ceranic,6,88,8,19,0,1,0.0,8,18,0.44,0.42,16,23,0.7,7,17,24,0,2,1,6,20,32,0.55,17.08
Dragan Dojcin,14,162,12,34,4,15,0.27,8,19,0.42,0.41,6,8,0.75,6,15,21,8,3,0,7,20,34,0.45,15.72
Dragan Lukovski,47,1266,161,365,46,123,0.37,115,242,0.48,0.5,249,298,0.83,21,73,94,198,53,4,117,97,617,0.62,19.08
Dragan Milosavljevic,77,1805,214,511,63,213,0.3,151,298,0.51,0.48,101,139,0.72,77,141,218,88,52,19,121,186,592,0.52,17.46
Dragan Tarlac,10,180,27,47,0,1,0.0,27,46,0.59,0.57,15,24,0.62,14,28,42,4,5,8,18,20,69,0.6,23.82
Dragan Vukcevic,24,421,43,129,17,73,0.23,26,56,0.46,0.4,26,37,0.72,5,19,24,12,6,2,23,50,129,0.44,13.67
Dragisa Drobnjak,41,805,84,167,8,36,0.22,76,131,0.58,0.53,36,56,0.67,47,84,131,36,31,11,43,107,212,0.55,18.33
Drago Pasalic,21,277,39,92,7,28,0.25,32,64,0.5,0.46,15,25,0.61,17,37,54,3,2,0,26,44,100,0.49,20.16
Drake Diener,20,315,40,91,22,54,0.41,18,37,0.49,0.56,21,22,0.88,22,22,44,17,9,2,16,38,123,0.61,13.71
Drazen Bubnic,10,110,15,32,1,7,0.14,14,25,0.56,0.48,9,11,0.82,7,13,20,5,1,0,8,25,40,0.54,17.84
Drew Crawford,7,121,16,36,5,14,0.36,11,22,0.5,0.51,3,4,0.75,4,9,13,2,4,1,6,21,40,0.53,13.71
Drew Gordon,10,288,36,83,1,9,0.11,35,74,0.47,0.44,18,29,0.62,25,50,75,15,11,11,16,21,91,0.48,14.32
Drew Nicholas,126,3609,524,1228,276,696,0.4,248,532,0.47,0.54,205,278,0.68,31,233,264,290,100,16,200,256,1529,0.57,12.9
Dror Hagag,24,253,20,61,6,22,0.27,14,39,0.36,0.38,14,16,0.9,7,21,28,22,17,0,20,29,60,0.44,22.72
Duane Woodward,12,320,41,94,14,34,0.41,27,60,0.45,0.51,17,24,0.71,5,17,22,20,22,0,28,30,113,0.54,21.12
Dusan Bocevski,17,413,70,134,18,45,0.4,52,89,0.58,0.59,35,51,0.6,31,49,80,13,12,2,26,56,193,0.62,14.25
Dusan Djordjevic,10,213,7,27,5,18,0.28,2,9,0.22,0.35,12,12,1.0,2,11,13,11,8,1,14,29,31,0.48,30.25
Dusan Kecman,151,3352,390,831,132,374,0.35,258,457,0.56,0.55,260,324,0.84,164,352,516,212,140,23,225,440,1172,0.6,18.77
Dusan Sakota,40,364,51,119,27,77,0.35,24,42,0.57,0.54,11,14,0.87,25,26,51,12,11,0,18,79,140,0.56,12.57
Dusan Stevic,10,224,38,84,10,31,0.32,28,53,0.53,0.51,11,21,0.52,18,29,47,0,18,1,19,38,97,0.52,16.93
Dusan Vukcevic,106,2275,342,757,155,393,0.39,187,364,0.51,0.55,174,215,0.84,17,166,183,147,101,14,141,177,1013,0.59,14.21
Dusko Savanovic,108,2698,409,976,123,350,0.35,286,626,0.46,0.48,214,271,0.8,143,332,475,146,91,27,146,178,1155,0.53,11.76
Dwayne Broyles,10,182,16,44,4,16,0.25,12,28,0.43,0.41,14,19,0.74,7,13,20,13,10,0,12,17,50,0.48,18.65
Dwight Buycks,6,105,19,41,4,9,0.44,15,32,0.47,0.51,9,9,1.0,2,8,10,15,3,0,12,12,51,0.57,21.07
Dylan Ennis,18,234,36,101,18,45,0.4,18,56,0.32,0.45,27,31,0.87,3,29,32,29,8,1,23,30,117,0.51,16.71
Dylan Page,7,203,39,74,15,36,0.42,24,38,0.63,0.63,12,13,0.92,5,23,28,12,2,0,12,15,105,0.66,13.08
Dzanan Musa,10,78,10,28,3,12,0.25,7,16,0.44,0.41,4,6,0.67,4,9,13,7,2,1,7,11,27,0.44,18.6
Dzenan Rahimic,18,421,85,163,7,16,0.44,78,147,0.53,0.54,46,75,0.61,37,54,91,3,12,0,22,53,223,0.57,10.09
Dzevad Alihodzic,26,387,34,77,5,14,0.36,29,63,0.46,0.47,21,47,0.38,25,41,66,12,20,7,28,62,94,0.48,22.28
EJ Rowland,14,323,41,98,6,17,0.35,35,81,0.43,0.45,16,20,0.8,6,24,30,41,12,1,20,23,104,0.49,15.77
Earl Calloway,61,1478,200,419,79,202,0.39,121,217,0.56,0.57,84,102,0.84,35,139,174,160,72,7,108,131,563,0.61,18.89
Earl Clark,29,798,131,328,40,103,0.39,91,225,0.4,0.46,38,55,0.69,22,86,108,29,22,17,43,43,340,0.48,10.88
Ed Cota,52,1585,215,456,34,103,0.33,181,353,0.51,0.51,111,149,0.8,61,109,170,262,64,4,126,106,575,0.55,19.46
Eddie Basden,9,204,22,47,2,9,0.22,20,38,0.53,0.49,7,10,0.7,7,20,27,15,19,1,13,20,53,0.52,20.19
Eddie Gill,20,338,36,85,18,45,0.4,18,40,0.45,0.53,34,41,0.83,3,32,35,28,18,1,38,37,124,0.6,26.94
Edgar Sosa,10,229,35,97,11,39,0.28,24,58,0.41,0.42,23,32,0.72,2,12,14,42,3,0,28,21,104,0.47,20.13
Edgaras Ulanovas,175,4346,414,921,108,290,0.37,306,631,0.48,0.51,317,383,0.82,220,400,620,298,89,38,214,354,1253,0.58,16.42
Edin Bavcic,10,231,16,45,6,25,0.24,10,20,0.5,0.42,14,20,0.7,15,25,40,5,3,0,14,29,52,0.48,20.65
Edo Muric,8,116,7,24,1,11,0.09,6,13,0.46,0.31,1,1,1.0,3,13,16,3,4,0,6,16,16,0.33,19.71
Eduardo Hernandez Sonseca,50,791,132,231,8,20,0.4,124,211,0.59,0.59,61,76,0.81,59,133,192,14,27,54,42,107,333,0.63,13.71
Edwin Jackson,91,1889,232,602,104,318,0.33,128,284,0.45,0.47,111,132,0.87,38,129,167,167,41,4,121,133,679,0.51,15.49
Efthimios Rentzias,65,1229,219,441,47,141,0.33,172,300,0.57,0.55,82,117,0.7,88,168,256,33,41,45,67,131,567,0.58,11.98
Ege Arar,8,80,7,22,2,10,0.2,5,12,0.42,0.36,3,5,0.6,2,9,11,1,1,2,2,10,19,0.39,7.63
Egehan Arna,7,39,3,13,2,5,0.4,1,8,0.12,0.31,1,2,0.5,1,2,3,1,2,0,0,4,9,0.32,0.0
Egidijus Dimsa,10,136,18,39,2,11,0.18,16,28,0.57,0.49,6,16,0.38,7,16,23,3,2,1,5,26,44,0.48,9.8
Egor Vialtsev,18,230,33,56,13,25,0.52,20,31,0.65,0.71,7,7,1.0,8,9,17,19,4,1,11,25,86,0.73,15.7
Egor Vyaltsev,74,834,80,195,50,124,0.4,30,71,0.42,0.54,44,54,0.73,14,59,73,56,25,3,43,140,254,0.58,16.43
Ekpe Udoh,58,1743,282,495,0,3,0.0,282,492,0.57,0.57,152,217,0.71,129,250,379,103,50,129,79,123,716,0.61,11.8
Eleftherios Bochoridis,22,179,16,39,8,15,0.53,8,24,0.33,0.51,2,5,0.42,3,13,16,19,3,0,14,40,42,0.51,25.36
Elias Harris,20,183,36,63,2,4,0.5,34,59,0.58,0.59,17,22,0.77,17,31,48,6,3,0,9,39,91,0.63,11.02
Elijah Bryant,27,534,91,185,35,84,0.42,56,101,0.55,0.59,9,13,0.69,14,63,77,55,24,3,34,69,226,0.59,15.13
Elijah Johnson,4,65,11,21,4,13,0.31,7,8,0.88,0.62,2,2,1.0,1,10,11,3,0,0,2,6,28,0.64,8.38
Elliot Williams,10,263,42,106,5,23,0.22,37,83,0.45,0.42,42,48,0.88,5,23,28,10,6,0,19,28,131,0.52,13.0
Elmer Bennett,76,2136,265,681,94,315,0.3,171,366,0.47,0.46,193,243,0.84,45,113,158,334,106,1,184,187,817,0.52,18.93
Elvir Ovcina,8,166,15,42,0,4,0.0,15,38,0.39,0.36,5,13,0.38,22,23,45,4,7,2,8,20,35,0.37,14.36
Emilio Kovacic,44,955,170,335,4,10,0.4,166,325,0.51,0.51,92,134,0.68,83,161,244,31,46,29,53,112,436,0.55,11.86
Emir Preldzic,190,4034,433,1052,131,433,0.3,302,619,0.49,0.47,273,396,0.68,140,443,583,544,142,26,274,341,1270,0.52,18.26
Emircan Kosut,19,142,22,46,1,6,0.17,21,40,0.52,0.49,12,16,0.73,10,14,24,8,4,5,12,26,57,0.54,18.45
Ender Arslan,237,4094,418,1164,210,666,0.32,208,498,0.42,0.45,279,397,0.7,37,212,249,448,150,1,264,365,1325,0.49,16.47
Engin Atsur,6,91,8,21,5,15,0.33,3,6,0.5,0.5,1,2,0.5,1,6,7,10,2,0,5,12,22,0.5,18.6
Erazem Lorbek,221,4731,807,1536,131,337,0.39,676,1199,0.56,0.57,280,419,0.64,288,607,895,197,155,107,201,432,2025,0.59,10.46
Ercan Bayrak,3,6,1,2,0,1,0.0,1,1,1.0,0.5,1,2,0.5,1,0,1,0,0,0,0,0,3,0.52,0.0
Erez Katz,10,86,8,26,2,9,0.22,6,17,0.35,0.35,10,14,0.71,1,5,6,4,9,1,8,10,28,0.44,19.92
Eric Burks,5,89,10,24,4,14,0.29,6,10,0.6,0.5,7,11,0.64,2,2,4,4,2,0,3,10,31,0.54,9.42
Eric Campbell,23,652,97,163,16,43,0.37,81,120,0.68,0.64,34,51,0.67,44,80,124,32,28,13,32,60,244,0.66,14.72
Eric Murdock,6,167,21,60,4,14,0.29,17,46,0.37,0.38,15,26,0.58,4,14,18,13,11,0,11,14,61,0.43,13.34
Eric Struelens,14,328,50,85,0,1,0.0,50,84,0.6,0.59,33,51,0.65,28,60,88,17,21,19,29,41,133,0.62,21.25
Eric Taylor,10,280,42,100,16,41,0.39,26,59,0.44,0.5,13,15,0.87,8,31,39,14,16,2,19,39,113,0.53,15.13
Erick Green,102,2022,361,798,123,308,0.4,238,490,0.49,0.53,182,210,0.84,23,131,154,113,65,9,69,134,1027,0.58,7.19
Erik Cleymans,10,223,10,56,4,35,0.11,6,21,0.29,0.21,17,21,0.81,4,8,12,4,4,0,12,25,41,0.31,15.54
Erik Daniels,2,28,7,15,0,2,0.0,7,13,0.54,0.47,1,3,0.33,2,6,8,2,1,0,2,4,15,0.46,10.92
Erjon Kastrati,3,39,3,9,1,4,0.25,2,5,0.4,0.39,2,2,1.0,1,3,4,4,1,0,1,8,9,0.46,9.19
Ermal Kuqo,114,1887,367,700,27,70,0.39,340,630,0.54,0.54,112,164,0.64,118,233,351,84,55,6,168,337,873,0.57,17.87
Ernests Kalve,5,29,3,6,0,1,0.0,3,5,0.6,0.5,2,6,0.33,0,2,2,1,3,0,1,7,8,0.46,10.37
Errick McCollum,29,768,146,340,52,130,0.4,94,210,0.45,0.51,79,102,0.78,14,55,69,67,23,12,59,60,423,0.55,13.29
Ersan Ilyasova,58,1049,169,397,52,161,0.32,117,236,0.5,0.49,62,93,0.61,89,215,304,41,39,49,53,109,452,0.52,10.8
Erving Walker,10,131,20,53,6,28,0.21,14,25,0.56,0.43,12,14,0.86,0,11,11,15,0,0,17,10,58,0.49,22.32
Esteban Batista,34,624,130,231,1,2,0.5,129,229,0.56,0.56,71,108,0.68,80,110,190,36,32,11,68,95,332,0.6,19.62
Eulis Baez,22,457,50,117,15,47,0.32,35,70,0.5,0.49,33,42,0.79,22,61,83,34,19,2,22,44,148,0.55,13.97
Eurelijus Zukauskas,11,144,21,52,1,1,1.0,20,51,0.39,0.41,25,44,0.57,18,21,39,2,17,5,12,24,68,0.48,14.4
Evangelos Koronios,15,337,39,97,23,55,0.42,16,42,0.38,0.52,44,48,0.87,8,19,27,37,13,1,23,39,145,0.61,16.3
Evgeny Baburin,23,426,38,101,25,66,0.38,13,35,0.37,0.5,12,13,0.92,10,37,47,20,26,0,22,53,113,0.53,17.09
Evgeny Voronov,81,1164,120,303,33,118,0.28,87,185,0.47,0.45,50,69,0.74,24,72,96,64,47,9,69,183,323,0.48,17.15
Evgueny Kissourine,10,287,23,64,6,25,0.24,17,39,0.44,0.41,27,36,0.75,18,30,48,8,10,4,15,34,79,0.49,15.82
Eyinmisan Nikagbatse,18,119,9,38,4,10,0.4,5,28,0.18,0.29,26,32,0.83,7,11,18,9,7,0,13,25,48,0.46,19.98
Fabien Causeur,218,4526,633,1285,202,526,0.38,431,759,0.57,0.57,237,321,0.74,103,373,476,387,142,25,273,392,1705,0.6,16.07
Fabien Dubos,22,299,40,85,5,26,0.19,35,59,0.59,0.5,20,25,0.87,13,39,52,13,2,4,25,48,105,0.55,20.66
Fabio Di Bella,10,249,22,58,3,17,0.18,19,41,0.46,0.41,17,23,0.74,6,24,30,17,20,1,25,29,64,0.47,26.85
Fabio Ribeiro,12,250,33,64,3,7,0.43,30,57,0.53,0.54,16,17,0.94,17,48,65,11,8,2,11,26,85,0.59,13.34
Fabio Zanelli,3,38,2,6,0,1,0.0,2,5,0.4,0.33,1,1,1.0,1,2,3,2,1,0,3,8,5,0.39,31.78
Fabricio Oberto,19,486,86,150,0,1,0.0,86,149,0.58,0.57,19,49,0.39,45,76,121,23,24,8,44,78,191,0.56,20.41
Fabrizio Ambrassa,6,33,2,6,1,5,0.2,1,1,1.0,0.42,3,3,1.0,0,3,3,1,2,0,0,1,8,0.55,0.0
Facu Campazzo,103,2260,260,655,123,348,0.35,137,307,0.45,0.49,197,228,0.82,26,205,231,531,142,3,212,245,840,0.56,21.92
Federico Kammerichs,15,198,22,63,4,21,0.19,18,42,0.43,0.38,19,27,0.7,21,28,49,12,4,5,10,16,67,0.45,11.78
Federico Lestini,10,118,11,26,7,13,0.54,4,13,0.31,0.56,1,2,0.5,1,7,8,2,3,1,7,16,30,0.56,20.66
Fedor Dmitriev,29,274,16,58,8,35,0.23,8,23,0.35,0.34,12,16,0.71,8,25,33,15,6,1,5,24,52,0.4,7.14
Felipe Reyes,266,4433,745,1519,40,124,0.32,705,1395,0.51,0.5,692,853,0.82,488,725,1213,197,125,54,311,679,2222,0.59,14.1
Fernando San Emeterio,187,4404,619,1297,221,558,0.4,398,739,0.54,0.56,300,376,0.81,140,450,590,357,92,2,230,272,1759,0.6,13.59
Ferran Lavina,30,475,43,112,12,47,0.26,31,65,0.48,0.44,35,42,0.81,16,38,54,20,14,2,29,59,133,0.51,18.18
Fikret Can Akin,17,269,19,70,7,31,0.23,12,39,0.31,0.32,9,9,1.0,5,11,16,22,5,1,15,29,54,0.37,16.86
Filip Covic,13,183,9,41,7,27,0.26,2,14,0.14,0.3,5,7,0.71,1,11,12,33,2,0,17,18,30,0.34,27.83
Filip Dylewicz,79,1338,152,348,29,97,0.3,123,251,0.49,0.48,77,124,0.58,112,192,304,70,52,29,72,135,410,0.51,15.17
Filip Kruslin,4,22,1,4,0,2,0.0,1,2,0.5,0.25,2,2,1.0,0,0,0,0,3,0,2,3,4,0.41,29.07
Filip Videnov,10,206,30,68,14,34,0.41,16,34,0.47,0.54,4,8,0.5,7,18,25,12,9,0,11,23,78,0.55,13.33
Florent Pietrus,122,2389,214,425,17,65,0.26,197,360,0.55,0.52,195,270,0.71,188,331,519,62,104,77,159,298,640,0.59,22.62
Fragiskos Alvertis,114,2202,301,665,154,367,0.42,147,298,0.49,0.57,186,233,0.79,41,144,185,66,68,10,84,288,942,0.61,9.86
Fran Pilepic,32,629,90,176,56,111,0.5,34,65,0.52,0.67,22,22,1.0,10,33,43,35,14,1,33,67,258,0.69,15.09
Fran Vazquez,82,1273,206,346,0,8,0.0,206,338,0.61,0.6,76,97,0.79,97,169,266,36,27,80,55,205,488,0.63,12.4
Frank Ntilikina,4,23,2,7,0,1,0.0,2,6,0.33,0.29,2,4,0.5,2,0,2,0,0,0,3,3,6,0.34,25.51
Frank Robinson,15,305,39,94,8,33,0.24,31,61,0.51,0.46,20,37,0.54,16,36,52,9,8,4,31,30,106,0.48,21.94
Fred House,62,1705,220,592,58,231,0.25,162,361,0.45,0.42,153,217,0.71,96,163,259,84,157,10,123,184,651,0.47,15.18
Fred Vinson,6,122,15,39,10,23,0.43,5,16,0.31,0.51,3,4,0.75,4,12,16,3,7,1,10,13,43,0.53,19.7
Frederic Fauthoux,81,1244,106,265,85,215,0.4,21,50,0.42,0.56,83,99,0.84,13,72,85,136,34,1,102,143,380,0.62,24.84
Frederic Weis,15,239,24,35,0,1,0.0,24,34,0.71,0.69,4,12,0.33,26,38,64,3,3,12,7,40,52,0.65,14.81
Furkan Korkmaz,38,372,38,95,23,55,0.42,15,40,0.38,0.52,19,26,0.68,9,35,44,25,13,3,15,52,118,0.55,12.35
Gabe Muoneke,11,162,25,49,7,16,0.44,18,33,0.55,0.58,14,16,0.88,8,22,30,4,7,0,7,14,71,0.63,11.1
Gabriel Deck,55,938,115,224,13,45,0.29,102,179,0.57,0.54,71,93,0.76,45,105,150,57,13,4,39,62,314,0.59,12.83
Gabriel Fernandez,6,64,9,16,6,10,0.6,3,6,0.5,0.75,3,6,0.5,2,5,7,1,1,0,0,11,27,0.72,0.0
Gal Mekel,34,589,72,180,13,35,0.37,59,145,0.41,0.44,36,52,0.81,9,64,73,119,11,2,51,55,193,0.48,20.09
Garlon Green,11,163,18,48,5,19,0.26,13,29,0.45,0.43,6,8,0.75,3,10,13,3,5,2,8,16,47,0.46,13.44
Gasper Vidmar,52,920,141,238,0,3,0.0,141,235,0.6,0.59,59,153,0.41,99,118,217,28,29,30,81,144,341,0.56,20.97
Gavrilo Pajovic,11,208,17,40,13,23,0.57,4,17,0.24,0.59,4,7,0.57,3,16,19,15,3,0,9,24,51,0.59,17.28
Gediminas Orelik,7,46,2,6,1,3,0.33,1,3,0.33,0.42,3,4,0.75,0,2,2,0,1,0,1,4,8,0.52,11.42
Geert Hammink,16,166,17,46,0,1,0.0,17,45,0.38,0.37,7,11,0.64,11,22,33,4,4,2,11,25,41,0.4,17.79
George Zidek,18,293,42,95,24,50,0.48,18,45,0.4,0.57,18,29,0.59,13,34,47,6,3,1,13,53,126,0.58,10.77
Georgios Giannouzakos,33,403,37,85,17,45,0.38,20,40,0.5,0.54,4,6,0.5,9,30,39,25,13,1,15,58,95,0.54,14.61
Georgios Kalaitzis,111,1687,106,259,42,113,0.37,64,146,0.44,0.49,79,107,0.75,42,143,185,138,85,4,99,296,333,0.54,24.44
Georgios Papagiannis,27,474,85,137,0,2,0.0,85,135,0.63,0.62,16,24,0.67,42,86,128,6,10,25,27,53,186,0.63,15.47
Gerald Brown,22,696,81,191,15,48,0.31,66,143,0.46,0.46,49,59,0.84,14,50,64,47,32,1,42,69,226,0.52,16.22
Gerald Fitch,23,548,94,251,28,100,0.28,66,151,0.44,0.43,49,79,0.67,28,55,83,37,26,4,42,47,265,0.46,12.81
German Gabriel,47,569,91,173,43,90,0.48,48,83,0.58,0.65,43,60,0.79,26,86,112,25,22,5,34,69,268,0.67,14.57
German Scarone,24,413,41,114,19,66,0.29,22,48,0.46,0.44,43,52,0.82,9,34,43,21,20,1,35,63,144,0.53,20.36
Gerrit Major,14,239,15,38,3,8,0.38,12,30,0.4,0.43,10,17,0.59,12,10,22,15,9,1,22,49,43,0.47,32.6
Gerrit Terdenge,10,274,43,97,3,14,0.21,40,83,0.48,0.46,26,30,0.87,17,28,45,14,4,3,17,37,115,0.52,13.36
Giacomo Devecchi,17,245,20,42,12,21,0.57,8,21,0.38,0.62,2,4,0.5,5,12,17,18,9,0,6,26,54,0.62,12.06
Giacomo Galanda,107,2341,307,649,114,286,0.4,193,363,0.53,0.56,104,135,0.77,129,295,424,90,98,31,149,339,832,0.59,17.38
Giancarlo Marcaccini,11,116,15,41,12,36,0.33,3,5,0.6,0.51,5,8,0.62,5,9,14,6,5,0,1,14,47,0.53,2.2
Gianluca Basile,223,5771,710,1744,421,1150,0.37,289,594,0.49,0.53,322,397,0.82,99,461,560,477,262,21,296,480,2163,0.56,13.37
Gianmarco Pozzecco,53,977,104,225,29,88,0.33,75,137,0.55,0.53,120,143,0.79,17,64,81,221,51,0,149,143,357,0.62,34.1
Giannis Georgalis,10,120,9,24,3,8,0.38,6,16,0.38,0.44,7,10,0.7,8,11,19,6,6,2,9,19,28,0.49,24.06
Giannis Giannoulis,13,222,33,41,0,1,0.0,33,40,0.82,0.8,29,49,0.59,18,39,57,7,13,5,23,30,95,0.76,26.88
Giannis Sioutis,8,103,2,16,1,9,0.11,1,7,0.14,0.16,5,6,0.83,3,7,10,4,1,0,5,14,10,0.27,21.15
Giedrius Gustas,38,430,56,143,26,66,0.39,30,77,0.39,0.48,28,35,0.68,10,14,24,30,17,1,20,72,166,0.52,11.21
Gintaras Einikis,31,643,121,258,20,56,0.36,101,202,0.5,0.51,26,35,0.67,38,82,120,15,17,14,17,87,288,0.53,5.85
Giorgi Shermadini,52,701,105,191,0,7,0.0,105,184,0.57,0.55,114,147,0.71,71,91,162,19,18,34,62,103,324,0.63,19.52
Giorgio Boscagin,2,14,1,2,0,1,0.0,1,1,1.0,0.5,1,2,0.5,0,0,0,0,0,0,0,1,3,0.52,0.0
Giorgos Balogiannis,8,61,5,14,2,7,0.29,3,7,0.43,0.43,6,6,1.0,0,7,7,5,2,0,4,9,18,0.54,19.38
Giorgos Diamantopoulos,15,368,60,107,16,33,0.48,44,74,0.59,0.64,50,63,0.79,15,16,31,22,12,3,16,29,186,0.69,10.62
Giorgos Pantazopoulos,14,196,15,48,12,38,0.32,3,10,0.3,0.44,10,12,0.83,0,10,10,12,7,0,18,22,52,0.49,25.25
Giorgos Printezis,302,6817,1275,2602,201,609,0.33,1074,1993,0.54,0.53,458,666,0.67,357,966,1323,310,115,55,284,477,3209,0.55,8.93
Giorgos Sigalas,33,673,60,177,26,80,0.32,34,97,0.35,0.41,52,72,0.62,8,80,88,57,42,7,51,111,198,0.47,19.64
Giorgos Tsiaras,27,225,26,56,4,22,0.18,22,34,0.65,0.5,12,21,0.58,12,34,46,9,12,1,14,48,68,0.52,17.67
Giuseppe Poeta,10,130,11,26,5,12,0.42,6,14,0.43,0.52,12,14,0.86,6,10,16,11,5,0,8,9,39,0.61,19.92
Goga Bitadze,13,315,51,93,5,16,0.31,46,77,0.6,0.58,50,70,0.71,33,50,83,15,6,30,18,47,157,0.63,12.69
Goksenin Koksal,54,651,52,143,23,65,0.35,29,78,0.37,0.44,15,30,0.47,27,25,52,30,21,0,36,79,142,0.45,18.73
Gokturk Ural,8,56,6,11,2,3,0.67,4,8,0.5,0.64,2,2,1.0,2,4,6,5,1,0,4,4,16,0.67,25.19
Gonzalo Martinez,10,189,13,41,7,24,0.29,6,17,0.35,0.4,16,18,0.89,1,7,8,29,6,0,16,23,49,0.5,24.65
Goran Cakic,18,242,27,62,4,27,0.15,23,35,0.66,0.47,10,14,0.72,13,22,35,2,9,2,9,47,68,0.5,11.66
Goran Dragic,15,369,52,107,9,35,0.26,43,72,0.6,0.53,18,25,0.85,17,21,38,41,15,4,35,44,129,0.55,22.88
Goran Jagodnik,48,1237,211,547,90,258,0.35,121,289,0.42,0.47,133,161,0.83,45,199,244,44,61,8,95,155,645,0.52,13.33
Goran Jeretin,10,169,16,38,7,22,0.32,9,16,0.56,0.51,16,20,0.8,1,14,15,10,9,0,21,27,55,0.59,30.97
Goran Jurak,61,1335,189,385,17,58,0.29,172,327,0.53,0.51,127,217,0.59,112,198,310,65,63,6,110,213,522,0.54,18.63
Goran Nikolic,25,532,81,144,5,13,0.38,76,131,0.58,0.58,19,29,0.82,35,90,125,21,16,13,22,44,186,0.59,12.31
Goran Suton,10,129,17,37,4,15,0.27,13,22,0.59,0.51,3,4,0.75,11,22,33,3,1,2,10,22,41,0.53,20.51
Goran Vrbanc,17,300,34,82,17,48,0.35,17,34,0.5,0.52,13,15,0.9,2,18,20,14,7,0,20,31,98,0.55,18.42
Gordan Giriček,39,1107,211,473,51,164,0.31,160,309,0.52,0.5,141,174,0.82,23,96,119,48,32,1,83,89,614,0.56,13.12
Greg Brunner,6,84,11,25,1,3,0.33,10,22,0.45,0.46,2,7,0.29,5,10,15,3,1,2,3,15,25,0.45,9.65
Gregor Fucka,133,3530,621,1218,54,146,0.37,567,1072,0.53,0.53,334,543,0.59,261,557,818,128,140,106,236,354,1630,0.56,13.94
Grygorii Khizhniak,26,807,106,204,1,6,0.17,105,198,0.53,0.52,134,155,0.86,48,151,199,30,21,83,59,100,347,0.64,17.81
Guido Grunheid,13,178,14,42,2,18,0.11,12,24,0.5,0.36,8,9,0.89,8,20,28,11,6,2,18,23,38,0.41,28.14
Guilherme Giovannoni,31,653,81,187,30,78,0.38,51,109,0.47,0.51,42,52,0.82,24,83,107,36,39,6,26,70,234,0.56,11.02
Guillem Rubio,24,274,21,57,5,20,0.25,16,37,0.43,0.41,29,42,0.68,21,29,50,12,1,0,22,48,76,0.5,22.57
Guillem Vives,46,852,74,197,36,122,0.3,38,75,0.51,0.47,34,36,0.97,16,52,68,128,35,6,54,123,218,0.51,20.24
Gur Shelef,70,837,99,188,9,20,0.45,90,168,0.54,0.55,89,125,0.68,38,82,120,75,38,5,53,130,296,0.61,17.91
Gustavo Ayon,26,556,146,245,0,1,0.0,146,244,0.6,0.6,32,55,0.58,64,75,139,56,33,13,62,70,324,0.6,18.72
Gustavo Barrera,6,83,4,16,0,4,0.0,4,12,0.33,0.25,6,7,0.86,2,1,3,15,2,0,10,9,14,0.37,34.39
Guy Pnini,154,2390,241,560,149,385,0.39,92,175,0.53,0.56,95,135,0.72,43,195,238,185,60,7,87,248,726,0.59,12.32
Gytis Masiulis,12,38,5,7,1,1,1.0,4,6,0.67,0.79,3,4,0.75,1,8,9,1,1,0,2,7,14,0.8,18.59
Hakki Erdenay,38,844,155,352,75,183,0.41,80,169,0.47,0.55,77,99,0.77,17,44,61,64,28,0,49,63,462,0.58,11.02
Haluk Yildirim,49,1186,119,267,49,151,0.32,70,116,0.6,0.54,44,64,0.69,26,79,105,113,40,7,65,132,331,0.56,18.05
Hanno Mottola,83,1988,325,672,80,197,0.41,245,475,0.52,0.54,205,246,0.82,79,244,323,65,57,28,134,281,935,0.6,14.66
Haris Brkic,4,79,13,32,4,15,0.27,9,17,0.53,0.47,10,15,0.67,1,4,5,9,1,0,11,7,40,0.52,22.18
Haris Mujezinovic,68,1526,231,493,38,123,0.31,193,370,0.52,0.51,163,251,0.66,124,195,319,59,70,9,130,227,663,0.55,17.72
Harold Jamison,5,75,9,19,0,1,0.0,9,18,0.5,0.47,3,10,0.3,11,11,22,3,7,3,13,13,21,0.45,35.71
Harold Mrazek,64,1476,143,311,105,220,0.48,38,91,0.42,0.63,77,88,0.87,15,79,94,86,60,4,101,173,468,0.67,22.41
Hasan Ozkan,10,112,14,22,8,11,0.73,6,11,0.55,0.82,9,10,0.9,3,16,19,2,0,2,2,18,45,0.85,7.04
Hector Garcia,9,62,5,15,3,8,0.38,2,7,0.29,0.43,0,2,0.0,6,3,9,4,0,0,5,8,13,0.41,23.95
Hector Romero,14,66,9,13,1,2,0.5,8,11,0.73,0.73,2,3,0.67,8,9,17,1,1,0,5,7,21,0.73,25.88
Heiko Schaffartzik,63,1396,144,354,96,251,0.38,48,103,0.47,0.54,56,65,0.85,34,68,102,190,17,1,88,110,440,0.58,18.7
Henk Norel,9,116,11,34,0,2,0.0,11,32,0.34,0.32,6,10,0.6,11,9,20,4,1,3,7,18,28,0.36,15.42
Henrik Rodl,22,522,40,83,7,23,0.3,33,60,0.55,0.52,27,35,0.77,16,32,48,36,23,6,33,64,114,0.58,25.11
Henry Domercant,149,3692,544,1273,258,611,0.42,286,662,0.43,0.53,287,349,0.84,80,306,386,160,152,13,199,295,1633,0.57,12.24
Henry Walker,16,232,26,74,15,43,0.35,11,31,0.35,0.45,16,22,0.73,10,27,37,13,9,5,11,33,83,0.5,11.62
Henry Williams,12,362,60,134,26,68,0.38,34,66,0.52,0.54,36,38,0.95,5,17,22,25,13,0,18,28,182,0.6,10.67
Herve Toure,35,528,70,160,27,67,0.4,43,93,0.46,0.52,19,33,0.63,28,60,88,21,22,19,36,70,186,0.53,17.1
Hollis Price,26,848,133,288,68,161,0.42,65,127,0.51,0.58,60,69,0.85,6,52,58,89,24,0,73,67,394,0.62,18.65
Hollis Thompson,28,422,58,139,13,49,0.27,45,90,0.5,0.46,29,43,0.67,26,50,76,24,16,3,18,50,158,0.5,10.23
Horace Jenkins,26,792,149,326,49,151,0.32,100,175,0.57,0.53,97,123,0.79,12,47,59,78,33,7,70,58,444,0.58,15.55
Howard Sant-Roos,10,189,19,57,4,23,0.17,15,34,0.44,0.37,13,15,0.87,11,14,25,17,12,0,7,23,55,0.43,9.92
Hrvoje Peric,15,314,46,89,1,14,0.07,45,75,0.6,0.52,22,31,0.71,21,39,60,24,8,6,17,28,115,0.56,14.21
Hrvoje Perincic,22,434,49,120,17,51,0.33,32,69,0.46,0.48,16,23,0.62,10,45,55,14,15,0,18,54,131,0.5,12.15
Hugo Sconochini,16,258,29,68,6,25,0.24,23,43,0.53,0.47,22,29,0.82,11,28,39,17,11,2,25,38,86,0.53,23.64
Huseyin Besok,70,1212,230,487,8,19,0.42,222,468,0.47,0.48,117,182,0.64,98,224,322,81,34,31,86,173,585,0.52,13.17
Ian Vouyoukas,39,357,53,90,0,2,0.0,53,88,0.6,0.59,29,38,0.77,21,44,65,25,5,12,20,65,135,0.63,15.78
Ibrahim Diarra,14,234,3,18,0,1,0.0,3,17,0.18,0.17,1,4,0.25,7,21,28,12,7,0,14,27,7,0.18,41.47
Ibrahim Jaaber,56,1411,198,456,50,171,0.29,148,285,0.52,0.49,61,100,0.57,56,108,164,120,102,11,90,140,507,0.51,15.25
Ibrahim Kutluay,121,3323,440,1067,228,620,0.37,212,447,0.47,0.52,308,411,0.72,43,224,267,140,105,2,223,306,1416,0.57,15.16
Ignacio De Miguel,41,727,78,162,1,9,0.11,77,153,0.5,0.48,88,116,0.76,59,102,161,26,26,11,41,109,245,0.58,16.14
Ignacio Rodriguez,62,1004,77,185,32,93,0.34,45,92,0.49,0.5,68,92,0.72,22,100,122,125,55,1,56,97,254,0.56,19.89
Igor Ivaskovic,2,18,1,5,1,3,0.33,0,2,0.0,0.3,2,2,1.0,1,1,2,2,0,0,2,4,5,0.43,25.38
Igor Milicic,6,127,3,14,2,10,0.2,1,4,0.25,0.29,1,2,0.5,1,13,14,13,4,0,9,12,9,0.3,37.69
Igor Milosevic,15,216,17,45,3,18,0.17,14,27,0.52,0.41,17,24,0.71,4,18,22,30,4,0,15,40,54,0.49,21.26
Igor Rakocevic,159,4180,746,1663,277,721,0.38,469,942,0.5,0.53,559,685,0.81,64,296,360,319,134,5,352,257,2328,0.59,15.2
Ike Ofoegbu,6,77,4,11,3,4,0.75,1,7,0.14,0.5,16,20,0.8,8,10,18,2,0,3,4,17,27,0.68,16.81
Iker Iturbe,42,801,98,215,49,117,0.42,49,98,0.5,0.57,33,47,0.69,24,93,117,35,40,4,52,104,278,0.59,18.08
Ilian Evtimov,9,242,24,64,16,47,0.34,8,17,0.47,0.5,15,19,0.79,4,15,19,12,3,0,9,23,79,0.55,11.06
Ilimane Diop,99,1040,116,227,11,42,0.26,105,185,0.57,0.54,109,146,0.72,86,125,211,35,23,47,60,203,352,0.6,17.08
Ilkan Karaman,22,279,40,85,7,25,0.28,33,60,0.55,0.51,10,20,0.5,15,39,54,8,12,10,17,34,97,0.52,15.34
Immanuel McElroy,29,930,132,239,15,43,0.35,117,196,0.6,0.58,54,70,0.72,46,70,116,73,37,1,45,67,333,0.62,14.29
Ioannis Athinaiou,25,236,17,53,13,37,0.35,4,16,0.25,0.44,7,10,0.62,3,20,23,22,5,0,11,29,54,0.47,16.08
Ioannis Bourousis,272,5075,842,1640,125,362,0.35,717,1278,0.56,0.55,578,774,0.75,431,1147,1578,243,163,190,363,622,2387,0.6,15.49
Ioannis Kalampokis,43,718,65,163,17,63,0.27,48,100,0.48,0.45,73,95,0.72,12,61,73,50,35,1,52,111,220,0.54,20.25
Ioannis Papapetrou,169,3414,447,948,141,405,0.35,306,543,0.56,0.55,112,172,0.6,122,408,530,116,95,58,118,329,1147,0.56,10.34
Ira Clark,14,169,18,42,4,16,0.25,14,26,0.54,0.48,7,12,0.58,9,38,47,3,8,3,17,34,47,0.5,26.45
Isaac Austin,1,24,2,7,2,6,0.33,0,1,0.0,0.43,1,2,0.5,0,3,3,7,0,1,5,3,7,0.44,38.82
Isaiah Hartenstein,5,16,2,5,0,2,0.0,2,3,0.67,0.4,1,1,1.0,0,4,4,1,0,0,2,2,5,0.46,26.88
Ismael Santos,11,143,7,18,5,12,0.42,2,6,0.33,0.53,8,11,0.73,3,11,14,4,4,0,3,24,27,0.59,11.61
Istvan Nemeth,42,871,102,249,55,159,0.35,47,90,0.52,0.52,33,45,0.66,10,62,72,71,29,5,44,69,292,0.54,14.07
Itay Segev,9,72,5,18,0,1,0.0,5,17,0.29,0.28,5,13,0.38,7,10,17,3,4,0,4,9,15,0.32,14.43
Ivan Buva,1,9,1,3,0,1,0.0,1,2,0.5,0.33,3,6,0.5,0,0,0,0,0,0,0,3,5,0.44,0.0
Ivan Corrales,2,44,2,9,0,3,0.0,2,6,0.33,0.22,1,1,1.0,0,2,2,2,1,0,3,6,5,0.26,24.12
Ivan Grgat,14,283,54,108,1,1,1.0,53,107,0.5,0.5,38,52,0.73,33,23,56,5,8,5,18,54,147,0.56,12.09
Ivan Koljevic,14,262,34,96,22,71,0.31,12,25,0.48,0.47,35,38,0.92,9,12,21,17,7,1,14,23,125,0.55,11.05
Ivan Radenovic,10,211,28,57,4,17,0.24,24,40,0.6,0.53,22,34,0.65,10,25,35,17,6,1,13,22,82,0.57,15.3
Ivan Ramljak,9,170,16,35,4,12,0.33,12,23,0.52,0.51,1,3,0.33,6,20,26,13,7,2,5,27,37,0.51,12.1
Ivan Savelyev,15,94,5,15,0,4,0.0,5,11,0.45,0.33,5,7,0.71,2,8,10,11,4,0,7,28,15,0.41,27.91
Ivan Strebkov,8,40,5,14,4,12,0.33,1,2,0.5,0.5,2,2,1.0,1,0,1,2,1,0,3,11,16,0.54,16.78
Ivan Tomas,2,29,2,5,1,1,1.0,1,4,0.25,0.5,0,2,0.0,0,2,2,5,2,0,2,2,5,0.43,25.38
Ivan Ukhov,13,72,10,16,1,5,0.2,9,11,0.82,0.66,1,1,1.0,1,9,10,8,2,0,5,9,22,0.67,23.32
Ivan Zigeranovic,10,108,18,32,1,1,1.0,17,31,0.55,0.58,3,9,0.33,6,16,22,1,4,3,12,21,40,0.56,25.02
Ivan Zoroski,20,462,61,148,21,72,0.29,40,76,0.53,0.48,45,56,0.79,12,24,36,31,25,1,33,52,188,0.54,16.05
Ivica Jurkovic,26,572,61,160,21,84,0.25,40,76,0.53,0.45,31,51,0.75,34,58,92,17,28,4,32,73,174,0.48,14.92
Ivica Maric,10,319,35,83,21,52,0.4,14,31,0.45,0.55,26,31,0.84,7,22,29,59,37,0,30,40,117,0.61,23.69
Ivica Skalabrin,3,22,1,2,0,1,0.0,1,1,1.0,0.5,2,2,1.0,1,0,1,1,0,0,1,6,4,0.69,25.77
Izzet Turkyilmaz,7,49,3,8,0,2,0.0,3,6,0.5,0.38,3,4,0.75,4,7,11,1,2,1,6,6,9,0.46,38.07
J.R. Reynolds,6,126,9,33,4,15,0.27,5,18,0.28,0.33,7,8,0.88,1,7,8,15,3,1,11,20,29,0.4,23.15
JP Batista,10,238,49,87,0,1,0.0,49,86,0.57,0.56,16,24,0.67,15,23,38,15,7,4,26,34,114,0.58,21.04
JR Bremer,23,549,57,168,17,69,0.25,40,99,0.4,0.39,51,61,0.85,9,43,52,48,17,2,43,50,182,0.47,18.08
JR Giddens,10,244,34,71,9,19,0.47,25,52,0.48,0.54,13,17,0.76,10,42,52,8,5,1,11,26,90,0.57,12.29
JR Holden,209,6555,844,2216,377,1124,0.34,467,1092,0.43,0.47,323,479,0.69,75,361,436,608,247,4,349,363,2388,0.49,12.57
Jacob Pullen,40,748,138,338,60,181,0.33,78,157,0.5,0.5,67,83,0.9,11,35,46,95,27,2,71,49,403,0.54,15.94
Jacopo Giachetti,71,943,66,179,12,56,0.21,54,123,0.44,0.4,72,83,0.81,12,61,73,73,40,0,61,158,216,0.5,22.06
Jacques Stas,22,623,58,146,22,69,0.32,36,77,0.47,0.47,45,60,0.74,5,20,25,45,7,0,47,58,183,0.53,21.42
Jaka Blazic,141,2482,341,815,104,308,0.34,237,507,0.47,0.48,205,276,0.71,126,257,383,103,69,8,153,262,991,0.53,14.04
Jaka Klobucar,34,415,31,106,13,59,0.22,18,47,0.38,0.35,26,43,0.54,8,33,41,24,18,0,46,55,101,0.4,26.91
Jaka Lakovic,218,5496,735,1696,381,986,0.39,354,710,0.5,0.55,673,805,0.83,74,284,358,580,198,6,408,451,2524,0.62,16.6
Jake Cohen,83,767,100,204,28,66,0.42,72,138,0.52,0.56,35,47,0.76,47,77,124,46,23,4,40,113,263,0.59,15.11
Jake Wiley,31,434,85,134,0,2,0.0,85,132,0.64,0.63,29,40,0.75,32,29,61,11,17,16,21,44,199,0.66,12.17
Jakov Vladovic,3,32,3,6,1,3,0.33,2,3,0.67,0.58,1,2,0.5,0,2,2,2,1,0,0,4,8,0.58,0.0
Jakub Kudlacek,4,23,0,4,0,2,0.0,0,2,0.0,0.0,3,3,1.0,0,0,0,1,0,0,1,1,3,0.28,15.82
Jalen Jones,13,129,20,47,6,18,0.33,14,29,0.48,0.49,12,17,0.71,12,13,25,2,4,2,8,20,58,0.53,12.8
Jalen Reynolds,12,167,28,51,0,1,0.0,28,50,0.56,0.55,12,19,0.63,19,44,63,9,6,4,17,30,68,0.57,22.26
Jamal Shuler,10,294,44,86,10,23,0.43,34,63,0.54,0.57,14,15,0.93,3,27,30,20,6,1,18,20,112,0.6,16.27
Jamar Smith,35,791,141,325,74,168,0.44,67,157,0.43,0.55,26,31,0.84,15,46,61,85,29,1,50,56,382,0.56,12.87
Jamel McLean,93,1957,310,560,3,24,0.12,307,536,0.57,0.56,296,408,0.74,167,268,435,116,65,19,153,258,919,0.62,17.14
Jamel Thomas,6,128,19,63,3,20,0.15,16,43,0.37,0.33,12,19,0.63,11,10,21,4,7,1,12,9,53,0.37,14.4
James Anderson,154,3070,443,1057,183,521,0.35,260,536,0.49,0.51,155,199,0.78,99,398,497,178,78,42,134,257,1224,0.53,10.48
James Augustine,116,2488,383,594,5,22,0.23,378,572,0.66,0.65,105,173,0.59,241,389,630,135,95,71,84,202,876,0.65,11.14
James Bell,16,310,25,72,17,51,0.33,8,21,0.38,0.47,8,8,1.0,7,28,35,8,7,3,15,47,75,0.5,16.57
James Birsen,8,44,2,7,0,2,0.0,2,5,0.4,0.29,1,2,0.5,2,7,9,0,3,1,0,8,5,0.32,0.0
James Blackwell,8,271,35,65,10,20,0.5,25,45,0.56,0.62,28,33,0.85,4,14,18,33,15,1,21,28,108,0.68,20.89
James Brewer,5,84,15,38,4,18,0.22,11,20,0.55,0.45,5,8,0.62,3,5,8,8,4,2,10,20,34,0.41,19.41
James Feldeine,87,2034,267,699,120,348,0.34,147,351,0.42,0.47,109,138,0.74,23,116,139,200,87,17,107,129,763,0.5,12.35
James Forrest,20,494,95,181,1,2,0.5,94,179,0.53,0.53,59,85,0.69,37,83,120,10,13,5,33,74,250,0.57,13.13
James Gist,246,5806,825,1692,140,424,0.33,685,1268,0.54,0.53,398,608,0.65,393,680,1073,273,220,145,354,606,2188,0.56,15.3
James Nunnally,82,1595,221,452,99,204,0.49,122,248,0.49,0.6,99,109,0.92,38,131,169,125,41,13,82,138,640,0.64,14.09
James Shields,8,192,28,61,1,9,0.11,27,52,0.52,0.47,9,17,0.53,12,23,35,11,5,1,13,37,66,0.48,15.95
James Singleton,7,114,10,21,3,7,0.43,7,14,0.5,0.55,3,3,1.0,6,16,22,1,1,7,5,17,26,0.58,18.3
James Southerland,9,91,5,20,3,13,0.23,2,7,0.29,0.32,3,4,0.75,0,8,8,1,5,7,4,12,16,0.37,15.53
James Thomas,13,355,52,88,0,1,0.0,52,87,0.6,0.59,32,52,0.62,45,83,128,12,19,9,23,51,136,0.61,17.18
James White,55,1372,170,352,35,107,0.33,135,245,0.55,0.53,93,116,0.8,36,182,218,72,39,10,63,121,468,0.58,13.52
Jamie Arnold,47,682,125,233,6,22,0.27,119,211,0.56,0.55,96,119,0.81,59,126,185,22,20,15,48,77,352,0.62,14.4
Jamon Gordon,125,3346,449,1016,54,181,0.3,395,835,0.47,0.47,127,184,0.68,87,328,415,437,220,34,219,312,1079,0.49,16.64
Jamont Gordon,50,1239,189,431,46,149,0.31,143,282,0.51,0.49,102,138,0.77,33,144,177,156,56,24,122,120,526,0.53,19.88
Jan Jagla,48,840,108,267,46,147,0.31,62,120,0.52,0.49,39,51,0.75,65,128,193,21,27,21,49,111,301,0.52,14.48
Jan Mocnik,11,94,4,19,2,16,0.12,2,3,0.67,0.26,2,2,1.0,1,7,8,14,3,0,12,17,12,0.3,37.64
Jan Span,3,29,1,5,1,3,0.33,0,2,0.0,0.3,2,2,1.0,0,1,1,4,1,0,2,5,5,0.43,25.38
Jan Vesely,189,4620,737,1237,26,90,0.29,711,1147,0.62,0.61,381,666,0.55,347,561,908,264,186,126,267,597,1881,0.61,14.86
Janar Talts,13,211,13,46,5,29,0.17,8,17,0.47,0.34,7,11,0.64,10,32,42,6,4,8,10,41,38,0.37,16.44
Janis Blums,53,775,82,213,64,164,0.39,18,49,0.37,0.54,29,39,0.76,4,47,51,45,18,2,38,105,257,0.56,14.17
Janis Strelnieks,131,2788,386,800,175,413,0.42,211,387,0.55,0.59,209,230,0.92,24,205,229,335,85,3,138,237,1156,0.64,13.28
Janis Timma,77,1644,209,469,133,338,0.39,76,131,0.58,0.59,42,60,0.65,49,116,165,99,63,11,97,151,593,0.6,16.37
Jannero Pargo,11,138,14,39,6,21,0.29,8,18,0.44,0.44,4,6,0.67,3,6,9,15,4,0,17,18,38,0.46,28.99
Jared Homan,16,288,32,67,0,1,0.0,32,66,0.48,0.48,10,18,0.56,21,31,52,6,9,9,18,39,74,0.49,19.37
Jasmin Hukic,76,1665,222,554,121,324,0.37,101,230,0.44,0.51,74,100,0.75,53,180,233,79,50,10,86,162,639,0.53,12.57
Jasmin Perkovic,8,192,25,52,4,13,0.31,21,39,0.54,0.52,22,25,0.88,15,18,33,6,6,1,17,24,76,0.6,21.25
Jason Gardner,6,134,13,40,6,26,0.23,7,14,0.5,0.4,8,10,0.83,3,9,12,15,3,0,13,16,40,0.45,22.65
Jason Kapono,8,124,18,44,12,26,0.46,6,18,0.33,0.55,11,12,0.92,0,8,8,8,0,0,7,12,59,0.6,12.44
Jason Williams,6,106,7,26,3,7,0.43,4,19,0.21,0.33,3,6,0.5,7,6,13,4,4,0,8,14,20,0.35,21.83
Jay Larranaga,14,242,24,65,14,39,0.36,10,26,0.38,0.48,9,9,1.0,14,23,37,6,11,2,12,31,71,0.51,14.82
Jaycee Carroll,243,4194,825,1734,389,918,0.42,436,816,0.53,0.59,276,304,0.9,106,288,394,161,81,19,153,392,2315,0.62,7.57
Jayson Granger,148,3498,497,1213,159,458,0.35,338,755,0.45,0.48,211,281,0.74,47,309,356,591,99,11,265,278,1364,0.51,16.55
Je'Kel Foster,34,795,100,257,41,123,0.33,59,134,0.44,0.47,33,46,0.83,15,63,78,68,38,1,55,88,274,0.49,16.55
Jean Canelo,7,81,9,22,1,3,0.33,8,19,0.42,0.43,3,6,0.5,1,5,6,2,3,0,8,7,22,0.45,24.51
Jean Marc Jaumin,5,79,10,15,5,6,0.83,5,9,0.56,0.83,7,7,1.0,1,9,10,10,1,0,9,11,32,0.88,33.23
Jeff Brooks,92,2182,253,499,55,140,0.39,198,359,0.55,0.56,81,107,0.75,143,298,441,97,69,31,73,182,642,0.59,11.79
Jeff Greer,24,588,57,158,24,90,0.27,33,68,0.49,0.44,36,53,0.67,23,55,78,22,18,3,33,29,174,0.48,15.4
Jeff Kent,11,307,26,59,10,28,0.36,16,31,0.52,0.53,7,17,0.41,17,47,64,13,21,4,28,31,69,0.52,29.64
Jeff Nordgaard,24,270,25,79,14,54,0.26,11,25,0.44,0.41,14,17,0.8,11,33,44,8,7,1,8,39,78,0.45,8.47
Jeff Trepagnier,33,922,113,289,42,125,0.34,71,164,0.43,0.46,62,80,0.75,26,83,109,42,76,16,54,70,330,0.51,14.28
Jeff Varem,14,196,20,50,4,9,0.44,16,41,0.39,0.44,12,23,0.52,14,28,42,5,8,1,19,36,56,0.47,24.01
Jeffery Taylor,147,2611,275,583,107,276,0.39,168,307,0.55,0.56,92,138,0.65,102,176,278,148,57,18,89,302,749,0.58,12.15
Jeffrey Viggiano,17,286,35,86,15,47,0.32,20,39,0.51,0.49,10,13,0.74,9,31,40,22,12,7,17,35,95,0.52,15.64
Jemeil Rich,10,335,82,176,17,48,0.35,65,128,0.51,0.51,34,49,0.69,13,16,29,27,37,0,35,30,215,0.54,15.05
Jerel Blassingame,20,496,54,139,26,76,0.34,28,63,0.44,0.48,32,47,0.7,7,35,42,96,14,0,62,67,166,0.52,27.97
Jerel McNeal,15,225,22,52,8,26,0.31,14,26,0.54,0.5,7,11,0.64,10,18,28,17,11,1,16,39,59,0.52,21.97
Jeremiah Massey,65,1773,297,593,18,78,0.23,279,515,0.54,0.52,170,248,0.69,158,255,413,58,86,49,73,134,782,0.56,9.42
Jeremy Evans,48,1128,179,310,29,74,0.39,150,236,0.64,0.62,55,77,0.72,90,162,252,38,30,46,42,88,442,0.64,10.88
Jeremy Leloup,26,515,52,136,20,72,0.28,32,64,0.5,0.46,34,37,0.85,19,33,52,44,21,0,22,75,158,0.52,12.62
Jeremy Nzeulie,10,157,9,29,5,14,0.36,4,15,0.27,0.4,2,3,0.67,4,11,15,8,3,0,6,21,25,0.41,16.52
Jeremy Pargo,87,2151,314,764,81,276,0.29,233,488,0.48,0.46,141,202,0.67,33,178,211,308,44,6,178,185,850,0.5,17.27
Jeremy Richardson,13,254,33,76,12,32,0.38,21,44,0.48,0.51,6,8,0.75,3,28,31,2,3,2,14,19,84,0.53,14.97
Jermaine Jackson,2,71,12,17,1,2,0.5,11,15,0.73,0.74,7,9,0.78,1,3,4,12,6,0,4,5,32,0.76,16.03
Jerod Ward,3,65,16,37,8,16,0.5,8,21,0.38,0.54,7,7,1.0,4,6,10,1,1,1,3,5,47,0.59,6.96
Jerome Allen,12,384,44,101,9,37,0.24,35,64,0.55,0.48,42,54,0.78,8,38,46,42,15,1,19,15,139,0.56,13.22
Jerome Dyson,10,239,36,102,13,45,0.29,23,57,0.4,0.42,17,32,0.53,9,16,25,30,17,1,34,29,102,0.44,22.65
Jerome James,4,75,14,41,0,1,0.0,14,40,0.35,0.34,4,8,0.5,6,10,16,1,2,2,7,18,32,0.36,13.59
Jerome Randle,6,146,19,69,1,16,0.06,18,53,0.34,0.28,4,5,0.8,2,8,10,18,6,0,9,13,43,0.3,11.22
Jerry Hester,5,159,15,55,4,25,0.16,11,30,0.37,0.31,8,12,0.67,4,6,10,9,2,0,8,14,42,0.35,11.72
Jerry McCullough,10,233,29,69,5,18,0.28,24,51,0.47,0.46,31,36,0.86,9,17,26,21,18,0,17,24,94,0.55,16.69
Jerry Smith,4,98,8,27,1,9,0.11,7,18,0.39,0.31,8,10,0.8,3,7,10,7,1,0,8,15,25,0.4,20.3
Jeryl Sasser,3,20,2,7,1,2,0.5,1,5,0.2,0.36,1,2,0.5,2,2,4,2,0,0,0,1,6,0.38,0.0
Jesus Cilla,8,34,0,6,0,1,0.0,0,5,0.0,0.0,2,6,0.33,4,4,8,1,1,0,2,7,2,0.12,18.8
Jesus Lazaro,10,80,8,17,1,7,0.14,7,10,0.7,0.5,6,6,1.0,3,4,7,7,4,0,4,15,23,0.59,16.92
Jim Bilba,18,418,22,51,8,23,0.35,14,28,0.5,0.51,11,18,0.61,27,47,74,19,19,9,16,48,63,0.53,21.36
Jim Potter,12,274,36,88,22,45,0.49,14,43,0.33,0.53,18,24,0.75,10,23,33,7,3,4,7,31,112,0.57,6.63
Jimmer Fredette,27,575,109,230,45,108,0.42,64,122,0.52,0.57,84,88,0.96,10,48,58,48,21,0,36,36,347,0.65,11.81
Jimmy Oliver,14,386,60,133,33,84,0.39,27,49,0.55,0.58,13,15,0.87,7,24,31,13,9,0,12,19,166,0.59,7.92
Jiri Welsch,121,2946,365,827,90,259,0.35,275,568,0.48,0.5,267,376,0.7,97,261,358,204,135,12,218,267,1087,0.55,18.01
Joan Sastre,30,540,54,112,29,57,0.51,25,55,0.45,0.61,19,25,0.75,18,39,57,49,19,8,34,42,156,0.63,21.66
Jobey Thomas,15,377,61,138,30,76,0.39,31,62,0.5,0.55,29,33,0.88,7,15,22,10,10,0,17,39,181,0.59,10.03
Jock Landale,25,514,101,190,19,63,0.3,82,127,0.65,0.58,55,67,0.82,42,67,109,24,12,6,31,76,276,0.63,12.38
Joe Alexander,41,607,83,196,21,51,0.41,62,145,0.43,0.48,43,50,0.85,25,77,102,22,8,24,31,76,230,0.53,12.45
Joe Ingles,95,1785,190,429,74,213,0.35,116,216,0.54,0.53,80,106,0.75,35,171,206,167,59,7,99,137,534,0.56,17.23
Joe Ragland,31,621,92,227,37,106,0.35,55,121,0.45,0.49,35,42,0.84,15,44,59,92,20,2,38,59,256,0.52,13.4
Joel Bolomboy,55,717,82,165,19,53,0.36,63,112,0.56,0.55,38,55,0.67,61,101,162,23,11,19,28,84,221,0.58,12.89
Joel Freeland,43,1020,218,409,11,46,0.24,207,363,0.57,0.55,79,109,0.71,74,188,262,37,18,16,57,101,526,0.58,11.09
Joey Dorsey,14,235,29,48,0,2,0.0,29,46,0.63,0.6,11,27,0.45,32,39,71,10,12,13,28,44,69,0.58,31.86
Joffre Lleal,10,290,36,94,15,40,0.38,21,54,0.39,0.46,28,34,0.82,6,17,23,21,11,2,24,28,115,0.53,18.05
Joffrey Lauvergne,72,1544,250,468,20,70,0.29,230,398,0.58,0.56,97,158,0.62,119,242,361,86,26,17,87,122,617,0.57,13.93
Johan Petro,7,46,7,16,0,1,0.0,7,15,0.47,0.44,1,2,0.5,3,6,9,0,3,1,1,12,15,0.44,5.59
Johannes Strasser,9,80,4,13,3,6,0.5,1,7,0.14,0.42,2,2,1.0,2,2,4,8,1,0,10,10,13,0.47,41.88
Johannes Thiemann,16,228,35,64,7,13,0.54,28,51,0.55,0.6,21,28,0.75,22,28,50,12,5,0,9,33,98,0.64,10.55
Johannes Voigtmann,128,2924,414,790,124,322,0.39,290,468,0.62,0.6,139,198,0.68,186,534,720,241,72,44,144,228,1091,0.62,14.1
John Best,14,449,57,119,21,54,0.39,36,65,0.55,0.57,19,21,0.9,18,41,59,24,18,0,23,48,154,0.6,15.21
John Brown,14,400,92,170,10,18,0.56,82,152,0.54,0.57,20,31,0.64,40,54,94,22,16,6,48,43,214,0.58,20.72
John Bryant,44,901,157,335,14,45,0.31,143,290,0.49,0.49,57,80,0.71,74,197,271,52,25,21,57,132,385,0.52,13.34
John Celestand,20,444,52,133,16,50,0.32,36,83,0.43,0.45,38,49,0.72,4,25,29,75,11,2,44,49,156,0.5,22.16
John Cox,10,187,25,80,11,36,0.31,14,44,0.32,0.38,3,4,0.75,10,11,21,10,4,1,16,13,64,0.39,16.37
John DiBartolomeo,69,820,103,271,62,176,0.35,41,95,0.43,0.49,56,66,0.86,26,70,96,91,37,2,29,127,324,0.54,8.81
John Goldsberry,37,846,52,136,36,97,0.37,16,39,0.41,0.51,10,18,0.71,8,65,73,106,30,0,43,102,150,0.52,23.0
John Jerome,24,569,118,230,15,41,0.37,103,189,0.54,0.55,64,90,0.71,78,68,146,21,18,3,52,87,315,0.58,16.17
John Linehan,10,264,22,63,8,25,0.32,14,38,0.37,0.41,16,21,0.76,4,18,22,40,19,0,20,31,68,0.47,21.68
John McCord,13,243,31,64,1,1,1.0,30,63,0.48,0.49,16,34,0.47,11,25,36,16,4,6,12,16,79,0.5,13.19
John Rillie,6,92,10,31,4,15,0.27,6,16,0.38,0.39,3,3,1.0,4,4,8,0,2,0,5,7,27,0.42,13.4
John White,16,442,63,176,26,79,0.33,37,97,0.38,0.43,39,48,0.82,18,43,61,24,12,2,41,53,191,0.48,17.22
Johnathan Edwards,5,45,6,14,0,2,0.0,6,12,0.5,0.43,2,6,0.33,5,5,10,1,4,1,3,11,14,0.42,15.27
Johnny Branch,4,42,4,7,2,5,0.4,2,2,1.0,0.71,3,3,1.0,0,2,2,3,1,0,3,7,13,0.78,26.5
Johnny O'Bryant,30,702,119,303,37,121,0.31,82,182,0.45,0.45,44,56,0.79,30,146,176,39,14,10,60,78,319,0.49,15.48
Johnny Rogers,22,374,38,74,14,30,0.47,24,44,0.55,0.61,25,30,0.83,4,41,45,14,8,2,18,59,115,0.66,17.11
Jon Cortaberria,5,51,3,9,1,6,0.17,2,3,0.67,0.39,1,2,0.5,2,7,9,3,0,1,1,4,8,0.4,9.19
Jon Diebler,78,1622,171,368,130,276,0.47,41,92,0.45,0.64,53,62,0.87,30,100,130,111,33,3,56,155,525,0.66,12.41
Jon Stefansson,41,754,96,249,35,125,0.28,61,124,0.49,0.46,63,84,0.73,8,48,56,48,26,0,48,100,290,0.51,14.37
Jonah Bolden,29,613,77,158,23,72,0.32,54,86,0.63,0.56,22,43,0.51,34,125,159,45,34,27,30,68,199,0.56,14.5
Jonas Jerebko,28,663,116,221,36,85,0.42,80,136,0.59,0.61,45,55,0.82,26,105,131,48,21,11,21,69,313,0.64,7.89
Jonas Maciulis,239,4900,626,1454,255,712,0.36,371,742,0.5,0.52,302,425,0.72,227,521,748,245,250,27,260,570,1809,0.55,13.68
Jonas Mattisseck,28,384,24,70,18,53,0.34,6,17,0.35,0.47,9,11,0.82,13,16,29,21,11,0,21,43,75,0.5,21.91
Jonathan Holmes,7,89,11,23,4,12,0.33,7,11,0.64,0.57,10,12,0.83,8,11,19,2,2,1,11,19,36,0.64,28.0
Jonathan Tabu,18,385,38,113,21,64,0.33,17,49,0.35,0.43,11,24,0.45,5,31,36,57,14,0,26,40,108,0.44,17.38
Jonathan Wallace,4,78,9,18,5,12,0.42,4,6,0.67,0.64,2,2,1.0,0,5,5,5,1,0,1,7,25,0.66,5.03
Jordan Aboudou,10,123,16,33,2,11,0.18,14,22,0.64,0.52,3,5,0.6,10,10,20,2,6,3,6,18,37,0.53,14.56
Jordan Farmar,44,1250,205,454,69,174,0.4,136,280,0.49,0.53,90,109,0.72,22,135,157,164,38,3,111,83,569,0.57,18.11
Jordan Loyd,18,394,63,151,33,77,0.43,30,74,0.41,0.53,41,53,0.77,2,32,34,43,13,1,32,51,200,0.57,15.51
Jordan McRae,3,46,4,17,1,6,0.17,3,11,0.27,0.26,6,7,0.86,1,2,3,2,2,2,1,2,15,0.37,4.74
Jordan Mickey,54,1062,246,438,27,78,0.35,219,360,0.61,0.59,114,151,0.76,77,170,247,35,32,56,80,108,633,0.63,13.69
Jordan Taylor,26,527,71,188,24,72,0.33,47,116,0.41,0.44,41,60,0.68,10,28,38,98,14,3,39,65,207,0.48,15.39
Jordan Theodore,23,604,101,233,20,68,0.29,81,165,0.49,0.48,45,52,0.86,11,36,47,100,20,1,42,67,267,0.52,14.1
Jordi Trias,100,1558,218,359,8,29,0.28,210,330,0.64,0.62,79,135,0.6,141,236,377,114,48,52,94,118,523,0.62,18.35
Jorg Lutcke,14,321,28,66,8,33,0.24,20,33,0.61,0.48,18,23,0.78,9,23,32,16,9,0,16,54,82,0.54,17.37
Jorge Garbajosa,150,3951,548,1208,187,504,0.37,361,704,0.51,0.53,394,511,0.79,196,622,818,181,224,88,192,346,1677,0.59,11.82
Jorge Racca,13,222,39,68,16,27,0.59,23,41,0.56,0.69,11,14,0.79,6,10,16,5,9,3,7,19,105,0.71,8.62
Jorge Sing,3,25,3,5,1,3,0.33,2,2,1.0,0.7,1,1,1.0,0,5,5,3,1,1,3,3,8,0.74,35.55
Jose Antonio Paraiso,18,389,45,75,13,34,0.38,32,41,0.78,0.69,28,40,0.7,14,36,50,12,5,0,15,25,131,0.71,13.94
Jose Calderon,58,1366,165,341,60,145,0.41,105,196,0.54,0.57,130,154,0.85,45,98,143,119,72,6,80,127,520,0.64,16.37
Jose Fernandez,5,25,1,7,0,4,0.0,1,3,0.33,0.14,3,4,0.75,2,3,5,2,1,0,1,2,5,0.29,10.25
Jose Simeon,7,53,3,15,1,2,0.5,2,13,0.15,0.23,2,4,0.5,3,4,7,5,2,0,3,6,9,0.27,15.18
Josep Puerto,10,32,3,8,0,1,0.0,3,7,0.43,0.38,3,4,0.75,1,3,4,1,1,1,0,1,9,0.46,0.0
Joseph Blair,54,1897,314,525,1,6,0.17,313,519,0.6,0.6,158,281,0.56,183,390,573,60,78,50,102,133,787,0.61,13.59
Joseph Gomis,24,542,76,182,20,62,0.32,56,120,0.47,0.47,26,32,0.82,8,36,44,45,17,2,39,33,198,0.5,16.59
Josh Adams,16,269,36,76,15,39,0.38,21,37,0.57,0.57,25,30,0.83,5,20,25,32,7,2,18,36,112,0.63,16.79
Josh Boone,6,103,15,24,0,1,0.0,15,23,0.65,0.62,4,11,0.36,10,19,29,3,1,2,4,14,34,0.59,12.18
Josh Carter,30,790,68,210,43,139,0.31,25,71,0.35,0.43,44,59,0.76,24,49,73,39,21,6,27,63,223,0.47,10.27
Josh Childress,36,1037,170,337,22,77,0.29,148,260,0.57,0.54,83,129,0.64,49,121,170,55,41,20,69,61,445,0.57,14.91
Josh Fisher,7,106,6,18,2,12,0.17,4,6,0.67,0.39,3,4,0.75,2,3,5,4,3,0,1,11,17,0.43,4.82
Josh Heytvelt,20,387,53,112,22,60,0.37,31,52,0.6,0.57,16,21,0.75,20,65,85,4,12,10,17,48,144,0.59,12.3
Josh Huestis,15,200,22,49,9,25,0.36,13,24,0.54,0.54,5,7,0.71,10,16,26,4,6,7,8,20,58,0.56,13.32
Josh Magette,6,107,4,30,3,15,0.2,1,15,0.07,0.18,2,4,0.5,1,4,5,29,3,0,10,13,13,0.2,23.95
Josh Powell,25,320,55,100,1,2,0.5,54,98,0.55,0.56,16,22,0.73,23,45,68,6,1,9,21,55,127,0.58,16.07
Josh Shipp,41,988,108,249,31,92,0.34,77,157,0.49,0.5,39,45,0.86,44,84,128,44,36,7,35,93,286,0.53,11.52
Josip Jerko Vrankovic,31,776,101,231,41,109,0.38,60,122,0.49,0.53,53,70,0.67,22,76,98,45,30,4,45,74,296,0.57,14.67
Josip Sesar,44,994,160,406,68,218,0.31,92,188,0.49,0.48,68,112,0.6,14,50,64,78,33,10,73,113,456,0.5,13.82
Josko Poljak,37,605,90,179,0,6,0.0,90,173,0.52,0.5,38,62,0.61,51,102,153,13,18,10,40,91,218,0.53,16.24
Jovan Manovic,2,35,2,10,1,6,0.17,1,4,0.25,0.25,4,4,1.0,0,1,1,5,0,0,2,8,9,0.38,14.53
Juan Carlos Navarro,341,8200,1338,3139,623,1669,0.37,715,1470,0.49,0.53,853,991,0.86,85,463,548,834,249,2,564,522,4152,0.58,13.63
Juan Jasen,2,31,4,10,1,2,0.5,3,8,0.38,0.45,3,4,0.75,4,6,10,1,1,0,4,4,12,0.51,25.38
Juan Palacios,19,449,70,175,3,24,0.12,67,151,0.44,0.41,32,46,0.64,31,62,93,24,22,12,28,54,175,0.45,12.54
Judson Wallace,76,1146,102,271,49,142,0.35,53,129,0.41,0.47,53,76,0.7,72,181,253,65,48,14,38,169,306,0.5,11.1
Jukka Matinen,9,177,7,43,3,25,0.12,4,18,0.22,0.2,7,9,0.78,8,11,19,1,4,3,5,25,24,0.26,9.62
Julian Khazzouh,1,32,3,4,2,3,0.67,1,1,1.0,1.0,3,4,0.75,2,3,5,0,0,3,4,5,11,0.95,40.98
Julian Wright,9,89,13,25,0,1,0.0,13,24,0.54,0.52,8,16,0.5,8,10,18,2,3,8,5,5,34,0.53,13.5
Julius Jenkins,21,441,84,187,28,67,0.42,56,120,0.47,0.52,35,44,0.81,6,19,25,36,15,2,32,34,231,0.56,13.43
Junior Harrington,16,211,10,37,0,14,0.0,10,23,0.43,0.27,5,6,0.83,5,19,24,25,17,1,9,29,25,0.32,18.5
Jure Balazic,13,161,18,47,8,19,0.42,10,28,0.36,0.47,7,12,0.58,7,17,24,8,5,1,7,18,51,0.49,11.81
Jurica Golemac,72,1463,215,447,43,125,0.34,172,322,0.53,0.53,114,170,0.65,83,182,265,124,49,24,141,226,587,0.56,21.27
Jurica Ruzic,12,357,47,114,20,61,0.33,27,53,0.51,0.5,13,23,0.74,11,37,48,3,12,0,9,37,127,0.51,6.76
Jurica Zuza,6,76,14,26,0,1,0.0,14,25,0.56,0.54,4,6,0.67,9,12,21,1,1,1,4,9,32,0.56,12.25
Jurij Zdovc,17,456,36,101,23,70,0.33,13,31,0.42,0.47,17,21,0.81,5,30,35,36,17,5,23,48,112,0.51,17.26
Justin Carter,22,608,73,167,23,66,0.35,50,101,0.5,0.51,60,89,0.68,30,74,104,51,25,12,39,41,229,0.56,15.91
Justin Dentmon,32,873,164,377,92,212,0.43,72,165,0.44,0.56,83,97,0.84,9,83,92,117,36,3,96,101,503,0.6,18.62
Justin Doellman,81,1849,275,605,77,197,0.39,198,408,0.49,0.52,143,163,0.81,71,249,320,82,83,16,91,155,770,0.57,11.85
Justin Hamilton,49,1213,109,258,30,105,0.29,79,153,0.52,0.48,36,47,0.72,21,113,134,110,59,5,58,122,284,0.51,17.23
Jusuf Nurkic,6,22,5,8,1,1,1.0,4,7,0.57,0.69,0,2,0.0,0,4,4,0,1,3,1,3,11,0.62,10.12
K'Zell Wesson,14,368,52,110,2,10,0.2,50,100,0.5,0.48,36,58,0.62,33,61,94,27,6,8,38,34,142,0.52,21.9
K.C. Rivers,163,3696,518,1184,269,691,0.39,249,493,0.51,0.55,105,147,0.76,73,301,374,168,130,8,102,342,1410,0.56,7.55
Kai Nurnberger,12,264,16,52,8,24,0.33,8,28,0.29,0.38,9,12,0.85,2,15,17,24,9,1,16,36,49,0.43,21.83
Kalin Lucas,9,163,19,49,6,13,0.46,13,36,0.36,0.45,5,6,0.83,2,12,14,9,7,0,11,16,49,0.47,17.56
Kamil Chanas,8,61,7,16,2,7,0.29,5,9,0.56,0.5,3,3,1.0,2,1,3,0,1,0,4,14,19,0.55,18.76
Karam Mashour,6,41,4,13,0,4,0.0,4,9,0.44,0.31,1,2,0.5,4,8,12,1,0,1,0,8,9,0.32,0.0
Karim Souchu,21,484,68,165,18,71,0.25,50,94,0.53,0.47,20,35,0.53,11,33,44,15,14,1,21,36,174,0.48,10.43
Karlo Vragovic,10,96,4,10,0,2,0.0,4,8,0.5,0.4,7,8,0.88,4,5,9,8,2,0,9,12,15,0.55,39.96
Karol Gruszecki,10,121,4,25,1,17,0.06,3,8,0.38,0.18,3,4,0.75,2,9,11,1,1,4,9,9,12,0.22,25.17
Karsten Tadda,42,541,35,92,17,48,0.35,18,44,0.41,0.47,22,28,0.82,10,42,52,34,19,1,19,59,109,0.52,15.41
Kartal Ozmizrak,23,364,44,110,21,59,0.36,23,51,0.45,0.5,24,31,0.77,5,30,35,54,8,1,19,39,133,0.54,13.32
Kaspars Kambala,33,1003,219,371,1,2,0.5,218,369,0.59,0.59,109,170,0.65,71,152,223,20,33,7,68,100,548,0.61,13.23
Kaspars Vecvagars,22,245,22,62,11,29,0.38,11,33,0.33,0.44,12,14,0.79,1,15,16,25,4,0,16,41,67,0.49,19.01
Kaya Peker,74,1445,208,394,3,10,0.3,205,384,0.53,0.53,123,237,0.49,106,213,319,73,81,38,96,210,542,0.54,16.15
Keifer Sykes,12,226,30,87,16,44,0.36,14,43,0.33,0.44,11,13,0.85,4,10,14,24,5,1,17,28,87,0.47,15.49
Keith Jennings,5,124,21,45,1,5,0.2,20,40,0.5,0.48,8,10,0.8,4,12,16,9,6,0,18,12,51,0.52,26.71
Keith Langford,143,4082,772,1708,204,564,0.36,568,1144,0.5,0.51,541,698,0.76,100,344,444,367,111,24,284,280,2289,0.57,12.35
Keith McLeod,4,58,5,15,3,11,0.27,2,4,0.5,0.43,5,7,0.71,0,1,1,1,2,0,5,6,18,0.5,21.66
Kelly McCarty,34,916,108,259,43,104,0.41,65,155,0.42,0.5,75,87,0.85,27,112,139,32,35,22,36,59,334,0.56,10.8
Kenan Bajramovic,33,838,130,299,34,100,0.34,96,199,0.48,0.49,77,101,0.76,43,139,182,35,21,10,58,81,371,0.54,14.45
Kenan Karahodzic,6,34,4,8,2,5,0.4,2,3,0.67,0.62,2,2,1.0,3,4,7,1,2,0,2,4,12,0.68,18.38
Kenan Sipahi,47,595,48,126,13,57,0.23,35,69,0.51,0.43,21,30,0.71,9,34,43,68,25,1,31,89,130,0.47,18.21
Kendrick Ray,17,188,28,64,11,24,0.46,17,40,0.42,0.52,14,21,0.67,1,13,14,19,3,2,15,29,81,0.55,17.0
Kendrick Warren,9,285,65,132,9,26,0.35,56,106,0.53,0.53,22,41,0.54,20,49,69,7,9,0,29,35,161,0.54,16.2
Kennedy Winston,35,762,104,217,21,62,0.34,83,155,0.54,0.53,32,51,0.63,22,73,95,32,35,9,38,51,261,0.55,13.7
Kenneth Ogbe,18,155,17,39,5,13,0.38,12,26,0.46,0.5,5,6,0.83,4,18,22,5,5,0,10,15,44,0.53,19.36
Kenny Anderson,9,160,9,39,0,7,0.0,9,32,0.28,0.23,4,6,0.67,3,6,9,15,6,0,10,16,22,0.26,19.36
Kenny Gabriel,66,1005,116,267,53,158,0.34,63,109,0.58,0.53,27,40,0.67,55,140,195,27,29,25,28,129,312,0.55,8.96
Kenny Grant,10,97,8,24,6,14,0.43,2,10,0.2,0.46,2,2,1.0,1,6,7,10,4,0,5,15,24,0.48,16.73
Kenny Gregory,53,1648,292,557,42,92,0.46,250,465,0.54,0.56,59,101,0.57,65,191,256,81,33,13,102,106,685,0.57,14.5
Kenny Williams,2,67,12,26,0,3,0.0,12,23,0.52,0.46,7,13,0.54,4,15,19,3,0,1,4,7,31,0.49,11.2
Kerem Gonlum,201,3781,476,833,9,42,0.21,467,791,0.59,0.58,269,412,0.64,329,630,959,111,120,44,198,386,1230,0.61,16.33
Kerem Tunceri,160,3770,330,891,149,478,0.31,181,413,0.44,0.45,135,171,0.74,40,229,269,501,163,18,257,294,944,0.49,21.01
Kestutis Marciulonis,28,559,60,165,27,85,0.32,33,80,0.41,0.45,70,81,0.83,6,36,42,48,21,0,53,67,217,0.54,20.9
Kevin Fletcher,10,71,7,23,2,8,0.25,5,15,0.33,0.35,9,10,0.9,6,9,15,0,1,1,6,13,25,0.46,17.96
Kevin Houston,4,74,3,23,0,8,0.0,3,15,0.2,0.13,4,6,0.67,2,5,7,19,0,0,6,7,10,0.2,18.96
Kevin Jones,11,157,21,41,7,20,0.35,14,21,0.67,0.6,3,4,0.75,8,19,27,6,4,3,1,12,52,0.61,2.29
Kevin Murphy,5,95,11,33,2,6,0.33,9,27,0.33,0.36,5,7,0.71,1,9,10,4,2,1,9,8,29,0.4,19.96
Kevin Pangos,101,2328,339,795,167,391,0.43,172,404,0.43,0.53,117,152,0.79,36,156,192,419,68,2,190,238,962,0.56,18.06
Kevin Punter,23,467,89,220,32,91,0.35,57,129,0.44,0.48,56,67,0.8,5,29,34,27,12,2,17,47,266,0.53,6.38
Kevin Rankin,20,298,35,68,6,14,0.43,29,54,0.54,0.56,24,35,0.68,22,33,55,2,17,12,33,49,100,0.6,28.35
Kevin Seraphin,15,304,73,126,0,1,0.0,73,125,0.58,0.58,36,55,0.66,25,48,73,14,4,14,28,39,182,0.61,15.71
Kevinn Pinkney,15,299,54,106,14,33,0.42,40,73,0.55,0.58,38,45,0.84,18,35,53,15,14,6,21,45,160,0.64,14.31
Khalid El Amin,15,392,65,136,21,61,0.34,44,75,0.59,0.56,31,33,0.94,8,20,28,49,22,1,27,42,182,0.6,15.21
Kim English,4,74,11,33,4,13,0.31,7,20,0.35,0.39,4,6,0.67,1,8,9,4,2,1,2,7,30,0.42,5.31
Kim Tillie,124,2357,285,593,84,212,0.4,201,381,0.53,0.55,100,133,0.72,173,272,445,106,88,23,106,277,754,0.58,13.99
Kirk Penney,32,388,58,117,30,65,0.46,28,52,0.54,0.62,13,20,0.61,13,29,42,12,6,0,19,35,159,0.63,13.12
Kiwane Garris,20,540,53,132,28,72,0.39,25,60,0.42,0.51,48,60,0.8,9,39,48,54,28,0,31,42,182,0.57,16.37
Klemen Prepelic,31,419,50,139,30,96,0.31,20,43,0.47,0.47,38,49,0.77,3,32,35,55,10,1,28,46,168,0.52,14.85
Koko Archibong,43,879,69,182,14,54,0.26,55,128,0.43,0.42,21,36,0.54,34,102,136,30,30,12,46,119,173,0.44,18.86
Kornel David,81,2125,342,656,6,15,0.4,336,641,0.52,0.53,251,305,0.82,140,305,445,85,75,44,117,239,941,0.6,12.9
Kosta Perovic,12,311,38,88,0,1,0.0,38,87,0.44,0.43,33,53,0.62,25,31,56,11,15,11,22,46,109,0.49,16.5
Kostas Kaimakoglou,85,1812,184,428,73,202,0.36,111,226,0.49,0.52,110,146,0.76,77,221,298,126,62,15,97,163,551,0.56,16.46
Kostas Papanikolaou,231,5124,575,1242,235,624,0.38,340,618,0.55,0.56,284,394,0.67,225,680,905,336,204,87,269,435,1669,0.59,15.97
Kostas Sloukas,245,5375,652,1460,242,592,0.41,410,868,0.47,0.53,505,566,0.88,89,409,498,921,142,20,418,426,2051,0.6,19.65
Kostas Tsartsaris,239,4391,537,1089,99,309,0.32,438,780,0.56,0.54,329,475,0.72,264,641,905,215,125,73,261,640,1502,0.58,16.74
Kostas Vasileiadis,98,1843,243,606,155,419,0.37,88,187,0.47,0.53,144,167,0.89,45,152,197,80,59,8,99,157,785,0.58,12.72
Kresimir Loncar,44,783,135,268,5,24,0.21,130,244,0.53,0.51,67,85,0.76,54,99,153,40,22,14,55,124,342,0.56,15.26
Kresimir Nikic,11,119,13,27,0,1,0.0,13,26,0.5,0.48,3,8,0.38,6,16,22,6,6,4,10,14,29,0.48,24.68
Kris Hill,10,344,73,119,1,8,0.12,72,111,0.65,0.62,25,38,0.66,34,42,76,15,19,0,35,29,172,0.63,20.5
Kristaps Janicenoks,2,21,3,6,2,3,0.67,1,3,0.33,0.67,2,2,1.0,1,0,1,2,1,0,1,3,10,0.73,12.69
Kristaps Valters,13,263,31,89,19,59,0.32,12,30,0.4,0.46,26,36,0.72,6,17,23,40,10,1,27,24,107,0.51,20.48
Kristijan Nikolov,8,95,6,20,5,13,0.38,1,7,0.14,0.42,4,4,1.0,0,7,7,7,1,0,10,15,21,0.48,31.49
Kristjan Kangur,57,1080,111,246,64,151,0.42,47,95,0.49,0.58,58,70,0.79,49,99,148,52,23,8,54,146,344,0.62,16.32
Krunoslav Simon,176,4555,602,1402,262,716,0.37,340,686,0.5,0.52,297,353,0.84,109,547,656,518,136,32,293,373,1763,0.57,15.84
Krzysztof Roszyk,18,243,20,56,8,23,0.35,12,33,0.36,0.43,7,9,0.78,15,19,34,12,8,0,14,19,55,0.46,18.93
Ksistof Lavrinovic,124,2680,426,882,125,321,0.39,301,561,0.54,0.55,337,440,0.78,150,406,556,118,119,68,184,271,1314,0.61,14.61
Kyle Hill,30,792,116,273,61,156,0.39,55,117,0.47,0.54,38,48,0.71,17,41,58,51,36,5,42,64,331,0.56,12.5
Kyle Hines,149,3052,493,803,1,9,0.11,492,794,0.62,0.61,234,347,0.68,317,402,719,162,115,129,125,368,1221,0.64,11.57
Kyle Kuric,61,1194,188,413,97,233,0.42,91,180,0.51,0.57,65,74,0.88,45,85,130,53,46,6,40,78,538,0.6,8.24
Kyle Singler,8,185,25,54,5,13,0.38,20,41,0.49,0.51,10,16,0.62,11,23,34,6,3,3,12,21,65,0.53,16.43
Kyle Weems,10,258,31,87,13,44,0.3,18,43,0.42,0.43,4,8,0.5,4,30,34,19,12,6,10,29,79,0.44,9.95
Kyle Wiltjer,24,232,40,84,21,50,0.42,19,34,0.56,0.6,8,12,0.67,8,26,34,3,4,2,6,29,109,0.61,6.3
Lamayn Wilson,9,273,43,96,13,41,0.32,30,55,0.55,0.52,10,18,0.56,7,30,37,7,13,3,8,27,109,0.52,7.15
Lamont Hamilton,16,288,49,124,15,39,0.38,34,85,0.4,0.46,26,40,0.58,20,31,51,20,13,16,23,22,139,0.49,13.97
Laron Profit,7,115,7,16,2,7,0.29,5,9,0.56,0.5,6,7,0.86,1,21,22,9,8,2,4,11,22,0.58,17.33
Larry Ayuso,21,577,81,218,40,124,0.32,41,94,0.44,0.46,47,57,0.78,7,40,47,28,22,0,43,41,249,0.51,15.03
Larry Lewis,17,444,62,134,11,22,0.5,51,112,0.46,0.5,34,42,0.83,29,68,97,30,18,10,31,33,169,0.55,16.9
Larry Middleton,19,401,53,127,33,90,0.37,20,37,0.54,0.55,12,15,0.8,2,39,41,20,14,2,27,66,151,0.57,16.81
Latavious Williams,34,552,94,157,0,2,0.0,94,155,0.61,0.6,33,45,0.86,66,91,157,17,10,14,27,86,221,0.62,13.25
Laurent Cazalon,11,177,22,57,9,30,0.3,13,27,0.48,0.46,11,16,0.69,13,10,23,4,9,0,16,26,64,0.5,19.99
Laurent Foirest,88,2274,294,699,156,374,0.42,138,325,0.42,0.53,187,234,0.81,25,236,261,115,102,11,141,259,931,0.58,14.95
Laurent Sciarra,9,184,8,17,5,13,0.38,3,4,0.75,0.62,19,21,0.9,3,16,19,37,7,0,15,18,40,0.76,36.37
Lavor Postell,8,230,27,64,8,24,0.33,19,40,0.48,0.48,21,32,0.66,11,21,32,14,9,3,12,25,83,0.53,13.32
Lawrence Roberts,37,1010,95,258,33,98,0.34,62,160,0.39,0.43,71,111,0.63,74,162,236,61,38,17,82,113,294,0.48,21.09
Lazaros Agadakos,40,533,56,113,3,12,0.25,53,101,0.52,0.51,38,62,0.56,33,41,74,12,16,9,42,73,153,0.55,23.04
Lazaros Papadopoulos,4,55,7,17,0,1,0.0,7,16,0.44,0.41,2,4,0.5,5,4,9,0,1,0,2,5,16,0.43,9.63
Leandro Bolmaro,6,55,4,19,0,5,0.0,4,14,0.29,0.21,3,3,1.0,2,3,5,14,6,0,6,13,11,0.27,22.8
Leandro Palladino,17,445,45,113,32,69,0.46,13,44,0.3,0.54,15,22,0.68,6,34,40,15,16,1,10,28,137,0.56,7.54
Lee Matthews,10,312,57,107,1,8,0.12,56,99,0.57,0.54,36,53,0.68,29,34,63,3,20,7,17,26,151,0.58,11.54
Lenny Brown,7,195,31,60,8,25,0.32,23,35,0.66,0.58,17,24,0.71,3,10,13,13,8,0,21,20,87,0.62,22.94
Leo Mainoldi,22,315,26,79,20,55,0.36,6,24,0.25,0.46,2,4,0.5,8,34,42,12,10,1,3,37,74,0.46,3.58
Leo Westermann,130,2615,301,738,146,378,0.39,155,360,0.43,0.51,133,155,0.87,47,239,286,446,79,4,252,314,881,0.55,23.81
Leon Radosevic,114,2304,328,626,0,6,0.0,328,620,0.53,0.52,152,209,0.71,124,251,375,95,60,44,160,253,808,0.56,18.22
Levan Patsatsia,11,126,5,29,1,14,0.07,4,15,0.27,0.19,1,3,0.33,8,17,25,4,3,0,1,15,12,0.2,3.19
Levon Kendall,10,145,19,39,0,5,0.0,19,34,0.56,0.49,6,15,0.4,9,18,27,6,6,2,9,21,44,0.48,16.48
Lewis Sims,6,117,18,34,1,3,0.33,17,31,0.55,0.54,11,19,0.58,5,17,22,4,3,0,6,18,48,0.57,12.41
Linas Kleiza,70,1649,270,588,80,236,0.34,190,352,0.54,0.53,176,210,0.83,77,225,302,55,28,9,71,166,796,0.58,9.45
Linton Johnson,4,50,3,9,0,2,0.0,3,7,0.43,0.33,1,2,0.5,3,7,10,0,2,0,4,10,7,0.35,28.82
Lionel Chalmers,10,283,48,122,15,51,0.29,33,71,0.46,0.45,20,28,0.71,12,19,31,24,13,0,22,24,131,0.49,14.07
Lior Eliyahu,102,2095,436,774,2,16,0.12,434,758,0.57,0.56,154,229,0.68,136,295,431,157,68,31,135,176,1028,0.59,13.37
Lior Lubin,11,112,11,22,2,4,0.5,9,18,0.5,0.55,8,12,0.67,0,5,5,15,5,0,10,28,32,0.59,26.82
Livio Jean Charles,27,571,98,194,15,48,0.31,83,146,0.57,0.54,34,39,0.87,42,59,101,17,11,18,30,50,245,0.58,12.44
Lonnie Cooper,14,379,50,130,23,71,0.32,27,59,0.46,0.47,33,41,0.8,6,17,23,59,13,1,30,33,156,0.53,16.85
Lonny Baxter,10,252,43,75,0,1,0.0,43,74,0.58,0.57,24,35,0.69,15,37,52,2,3,9,16,32,110,0.61,15.04
Loren Woods,8,251,33,59,0,1,0.0,33,58,0.57,0.56,32,45,0.71,27,45,72,12,11,19,21,19,98,0.62,21.04
Lorenzo Brown,27,682,123,295,21,73,0.29,102,222,0.46,0.45,65,79,0.82,19,71,90,125,30,10,75,51,332,0.5,18.53
Louis Bullock,137,3565,610,1381,275,688,0.4,335,693,0.48,0.54,437,501,0.88,61,210,271,282,158,6,244,310,1932,0.6,13.22
Louis Campbell,20,540,60,152,32,83,0.39,28,69,0.41,0.5,15,21,0.72,14,34,48,81,18,2,55,33,167,0.52,25.43
Louis Labeyrie,27,547,47,95,12,37,0.32,35,58,0.6,0.56,33,41,0.8,37,86,123,20,13,8,17,35,139,0.61,13.07
Louis Olinde,15,115,9,20,1,8,0.12,8,12,0.67,0.48,13,15,0.87,4,17,21,4,3,0,9,21,32,0.6,25.28
Louis Rowe,13,391,63,152,17,56,0.3,46,96,0.48,0.47,34,43,0.79,8,32,40,25,17,2,35,49,177,0.52,17.0
Loukas Mavrokefalidis,104,1356,252,503,10,40,0.25,242,463,0.52,0.51,132,173,0.74,110,207,317,54,35,19,97,222,646,0.56,14.35
Lovro Mazalin,7,47,3,9,0,1,0.0,3,8,0.38,0.33,6,9,0.67,0,5,5,3,1,0,3,6,12,0.46,18.8
Lubos Barton,68,1390,202,441,72,213,0.34,130,228,0.57,0.54,77,96,0.79,96,171,267,57,69,20,57,124,553,0.57,10.55
Luc Arthur Vebobe,9,171,21,35,0,1,0.0,21,34,0.62,0.6,7,14,0.5,15,22,37,12,8,3,9,24,49,0.6,17.94
Luca Garri,33,586,61,188,19,85,0.22,42,103,0.41,0.38,38,56,0.68,59,86,145,11,45,8,35,70,179,0.42,14.13
Luca Vildoza,74,1452,179,446,92,255,0.36,87,191,0.46,0.5,79,93,0.86,22,116,138,228,66,14,123,166,529,0.54,20.17
Luca Vitali,29,627,69,169,39,95,0.41,30,74,0.41,0.52,56,67,0.85,9,33,42,52,18,1,61,82,233,0.59,23.51
Lucas Victoriano,13,298,30,83,18,58,0.31,12,25,0.48,0.47,17,24,0.71,2,28,30,44,12,0,19,36,95,0.51,16.88
Lucca Staiger,57,732,83,209,73,178,0.41,10,31,0.32,0.57,11,15,0.67,14,48,62,30,11,1,20,70,250,0.58,8.49
Lucio Angulo,46,973,108,225,23,68,0.34,85,157,0.54,0.53,116,139,0.83,30,81,111,61,64,9,78,126,355,0.62,21.42
Luigi Datome,198,4427,639,1344,274,627,0.44,365,717,0.51,0.58,248,272,0.94,174,543,717,211,109,57,220,486,1800,0.61,13.07
Luis Scola,142,3424,726,1302,25,79,0.32,701,1223,0.57,0.57,380,575,0.65,245,522,767,220,154,57,279,461,1857,0.6,15.21
Luka Babic,37,871,97,248,36,124,0.29,61,124,0.49,0.46,30,46,0.44,17,125,142,75,24,5,56,73,260,0.48,17.27
Luka Bogdanovic,71,1452,196,458,98,238,0.41,98,220,0.45,0.53,77,93,0.85,56,174,230,63,39,7,75,110,567,0.57,13.07
Luka Doncic,80,1685,252,569,101,294,0.34,151,275,0.55,0.53,240,290,0.85,63,281,344,314,68,21,152,103,845,0.61,17.91
Luka Mitrovic,79,1392,175,391,20,100,0.2,155,291,0.53,0.47,63,96,0.62,93,184,277,113,45,15,97,128,433,0.5,18.29
Luka Rupnik,4,57,5,13,1,6,0.17,4,7,0.57,0.42,2,2,1.0,0,0,0,6,3,0,3,9,13,0.47,17.77
Luka Zoric,24,454,84,151,0,1,0.0,84,150,0.56,0.56,30,39,0.77,33,53,86,4,5,14,42,66,198,0.59,19.98
Lukas Lekavicius,166,2589,373,808,109,275,0.4,264,533,0.5,0.53,165,205,0.8,53,166,219,363,76,4,214,308,1020,0.57,19.24
Lukasz Koszarek,30,857,95,240,36,100,0.36,59,140,0.42,0.47,41,45,0.92,11,81,92,137,19,2,71,75,267,0.51,21.46
Luke Harangody,62,1080,171,312,66,136,0.49,105,176,0.6,0.65,28,36,0.77,61,157,218,33,20,16,32,96,436,0.66,8.89
Luke Sikma,28,722,100,204,29,67,0.43,71,137,0.52,0.56,42,60,0.7,61,120,181,127,30,15,46,65,271,0.59,16.64
Luksa Andric,68,1147,173,317,15,53,0.28,158,264,0.6,0.57,66,98,0.72,90,160,250,32,52,29,92,232,427,0.59,20.35
Lynn Greer,92,2303,374,852,122,322,0.38,252,530,0.48,0.51,347,386,0.91,45,150,195,257,92,6,183,188,1217,0.6,15.19
Maarty Leunen,26,772,76,188,41,108,0.38,35,80,0.44,0.51,22,33,0.68,24,89,113,53,19,4,29,71,215,0.53,12.53
Maceo Baston,25,608,122,193,4,7,0.57,118,186,0.63,0.64,73,109,0.67,55,94,149,16,19,33,54,81,321,0.67,18.31
Maciej Lampe,83,1461,286,610,32,104,0.31,254,506,0.5,0.5,146,188,0.79,128,239,367,58,30,33,77,154,750,0.54,10.0
Maciej Zielinski,38,947,103,261,24,101,0.24,79,160,0.49,0.44,58,88,0.65,18,89,107,59,41,9,60,89,288,0.48,16.68
Mahmoud Abdul Rauf,17,194,34,89,10,29,0.34,24,60,0.4,0.44,1,2,0.5,2,12,14,12,11,0,15,21,79,0.44,14.3
Maik Zirbes,84,1632,292,509,0,4,0.0,292,505,0.58,0.57,143,207,0.7,187,220,407,47,54,37,126,226,727,0.61,17.35
Makai Mason,20,220,38,82,15,34,0.44,23,48,0.48,0.55,34,37,0.92,1,12,13,22,8,0,18,26,125,0.64,15.48
Makan Dioumassi,25,534,48,127,19,62,0.31,29,65,0.45,0.45,21,31,0.7,10,39,49,44,17,0,35,64,136,0.48,19.93
Malcolm Delaney,81,2294,323,762,167,411,0.41,156,351,0.44,0.53,291,355,0.79,34,209,243,403,67,5,190,227,1104,0.6,17.14
Malcolm Thomas,76,1523,214,391,23,80,0.29,191,311,0.61,0.58,92,130,0.76,149,213,362,114,62,31,71,171,543,0.61,13.67
Maleye N'Doye,10,213,22,56,9,28,0.32,13,28,0.46,0.47,5,6,0.83,6,10,16,8,7,0,8,20,58,0.49,12.0
Malik Hairston,59,1479,225,486,39,98,0.4,186,388,0.48,0.5,106,149,0.71,81,82,163,86,26,19,82,143,595,0.54,12.94
Mamadou Diop,4,10,1,5,1,3,0.33,0,2,0.0,0.3,1,2,0.5,1,1,2,0,0,0,1,2,4,0.34,14.53
Mamadou Samb,1,11,2,4,0,1,0.0,2,3,0.67,0.5,1,4,0.25,0,0,0,0,2,2,1,0,5,0.43,14.79
Mamoutou Diarra,10,116,7,30,2,11,0.18,5,19,0.26,0.27,6,8,0.75,1,10,11,4,2,0,9,14,22,0.33,21.17
Manolis Papamakarios,59,1039,95,243,52,144,0.36,43,99,0.43,0.5,59,76,0.76,13,89,102,79,59,2,56,138,301,0.54,16.85
Mantas Kalnietis,174,3606,465,1053,127,418,0.3,338,635,0.53,0.5,134,192,0.66,45,339,384,507,124,17,330,211,1191,0.52,22.49
Manu Ginobili,44,1280,223,498,62,197,0.31,161,301,0.53,0.51,175,225,0.78,40,135,175,110,120,14,109,141,683,0.57,15.44
Manuchar Markoishvili,126,2306,292,710,120,327,0.37,172,383,0.45,0.5,106,131,0.76,61,161,222,142,99,7,120,331,810,0.53,13.52
Maodo Lo,113,1993,292,667,131,323,0.41,161,344,0.47,0.54,75,99,0.75,19,149,168,235,63,9,155,234,790,0.56,17.91
MarQuez Haynes,55,994,111,300,62,177,0.35,49,123,0.4,0.47,42,58,0.78,14,57,71,73,18,5,56,81,326,0.5,14.68
MarShon Brooks,24,526,115,257,33,94,0.35,82,163,0.5,0.51,45,53,0.85,17,49,66,33,16,6,35,45,308,0.55,11.1
Marc Antoine Pellin,14,384,24,55,5,17,0.29,19,38,0.5,0.48,13,18,0.72,10,31,41,63,24,2,39,28,66,0.52,38.27
Marc Fernandez,4,36,3,10,1,5,0.2,2,5,0.4,0.35,1,1,1.0,2,2,4,0,0,0,2,3,8,0.38,16.08
Marc Gasol,19,196,25,39,1,3,0.33,24,36,0.67,0.65,19,31,0.62,10,31,41,6,9,7,10,34,70,0.66,15.96
Marc Jackson,20,552,101,212,11,26,0.42,90,186,0.48,0.5,88,100,0.88,44,76,120,29,11,11,50,45,301,0.59,16.34
Marc Judith,10,134,3,8,0,3,0.0,3,5,0.6,0.38,6,8,0.75,9,5,14,16,6,0,9,21,12,0.52,43.86
Marc Salyers,14,475,110,232,29,83,0.35,81,149,0.54,0.54,56,81,0.69,38,54,92,22,22,5,32,33,305,0.57,10.68
Marcelinho Machado,12,318,30,95,15,57,0.26,15,38,0.39,0.39,17,17,1.0,8,27,35,21,11,0,21,30,92,0.45,17.01
Marcelo Damiao,9,84,5,12,0,3,0.0,5,9,0.56,0.42,4,13,0.31,5,18,23,1,6,1,3,12,14,0.4,14.48
Marcelo Huertas,228,4679,645,1426,191,515,0.37,454,911,0.5,0.52,278,317,0.88,95,340,435,892,134,4,440,354,1759,0.56,21.94
Marcelo Nicola,86,1761,268,600,157,401,0.39,111,199,0.56,0.58,156,193,0.81,45,259,304,139,79,33,120,228,849,0.62,14.91
Marcelus Kemp,3,85,13,32,4,13,0.31,9,19,0.47,0.47,9,9,1.0,1,7,8,4,2,0,2,2,39,0.54,5.27
Marcin Gortat,14,388,57,96,1,2,0.5,56,94,0.6,0.6,30,45,0.67,27,52,79,17,15,15,30,39,145,0.63,20.58
Marcin Sroka,10,102,9,22,3,11,0.27,6,11,0.55,0.48,4,7,0.57,5,9,14,3,3,0,6,15,25,0.5,19.31
Marco Belinelli,76,1523,211,482,96,253,0.38,115,229,0.5,0.54,80,110,0.73,32,67,99,70,55,1,73,146,598,0.56,12.1
Marco Carraretto,92,995,98,221,51,122,0.42,47,99,0.47,0.56,28,36,0.78,13,60,73,42,34,0,28,115,275,0.58,10.57
Marco Cusin,10,162,27,42,0,1,0.0,27,41,0.66,0.64,7,11,0.64,11,16,27,6,1,14,4,28,61,0.65,7.87
Marco Mordente,72,1611,182,389,85,189,0.45,97,200,0.48,0.58,88,107,0.84,36,115,151,99,61,2,88,201,537,0.62,16.79
Marco Samanic,14,235,39,69,7,21,0.33,32,48,0.67,0.62,24,31,0.77,16,27,43,15,1,6,23,45,109,0.66,21.77
Marco Sassella,5,36,1,7,0,3,0.0,1,4,0.25,0.14,3,4,0.75,1,3,4,1,2,0,1,2,5,0.29,10.25
Marcus Banks,21,292,34,84,19,44,0.43,15,40,0.38,0.52,33,45,0.73,2,26,28,30,9,0,18,30,120,0.58,14.78
Marcus Brown,178,5517,852,1865,323,821,0.39,529,1044,0.51,0.54,688,803,0.88,93,347,440,457,184,18,338,444,2715,0.61,13.22
Marcus Denmon,28,365,53,130,35,84,0.42,18,46,0.39,0.54,15,18,0.83,9,14,23,29,13,2,16,37,156,0.57,10.4
Marcus Eriksson,51,1084,188,415,116,265,0.44,72,150,0.48,0.59,57,65,0.88,16,66,82,43,33,5,34,52,549,0.62,7.12
Marcus Faison,9,249,41,67,19,33,0.58,22,34,0.65,0.75,35,38,0.92,7,15,22,13,10,1,22,30,136,0.81,20.81
Marcus Fizer,15,257,67,116,4,11,0.36,63,105,0.6,0.59,34,49,0.69,8,46,54,18,8,3,27,45,172,0.63,16.41
Marcus Goree,119,3502,517,1108,85,232,0.37,432,876,0.49,0.5,226,363,0.62,244,483,727,152,126,120,159,230,1345,0.53,11.14
Marcus Haislip,72,1906,312,679,67,202,0.33,245,477,0.51,0.51,189,263,0.73,121,277,398,34,48,80,108,174,880,0.55,11.96
Marcus Johnson,5,86,4,18,0,4,0.0,4,14,0.29,0.22,0,2,0.0,2,10,12,2,4,2,6,8,8,0.21,24.12
Marcus Slaughter,31,384,42,61,0,2,0.0,42,59,0.71,0.69,16,34,0.47,26,47,73,15,18,9,16,66,100,0.66,17.4
Marcus Taylor,5,66,10,36,2,8,0.25,8,28,0.29,0.31,2,3,0.67,6,2,8,8,1,0,3,10,24,0.32,7.44
Marcus Williams,75,1738,225,671,116,371,0.31,109,300,0.36,0.42,110,152,0.73,32,168,200,334,42,2,152,96,676,0.46,17.08
Mardy Collins,32,567,85,200,12,45,0.27,73,155,0.47,0.46,22,40,0.6,17,61,78,71,24,4,49,62,204,0.47,18.38
Marijan Mance,75,1303,173,346,35,90,0.39,138,256,0.54,0.55,65,86,0.76,42,106,148,57,45,1,65,121,446,0.58,14.48
Marin Rozic,86,1508,152,375,32,112,0.29,120,263,0.46,0.45,98,125,0.77,54,183,237,41,78,5,82,192,434,0.5,16.02
Marin Vrsaljko,5,23,2,6,0,1,0.0,2,5,0.4,0.33,0,1,0.0,0,2,2,0,0,0,1,3,4,0.31,13.44
Marino Bazdaric,58,1555,227,532,106,290,0.37,121,242,0.5,0.53,129,156,0.76,25,176,201,85,73,1,95,161,689,0.57,13.66
Mario Bosnjak,1,20,4,6,0,1,0.0,4,5,0.8,0.67,0,1,0.0,2,0,2,0,1,0,2,2,8,0.62,23.7
Mario Delas,45,694,69,167,10,42,0.24,59,125,0.47,0.44,32,45,0.73,45,62,107,27,18,4,34,107,180,0.48,15.4
Mario Dundovic,12,184,18,47,2,14,0.14,16,33,0.48,0.4,12,16,0.75,8,23,31,6,5,2,22,33,50,0.46,28.93
Mario Gigena,12,176,12,36,6,21,0.29,6,15,0.4,0.42,7,9,0.78,3,9,12,6,8,0,13,25,37,0.46,24.55
Mario Hezonja,36,449,70,153,31,84,0.37,39,69,0.57,0.56,21,28,0.75,12,39,51,25,13,4,26,48,192,0.58,13.59
Mario Kasun,25,479,100,168,0,2,0.0,100,166,0.6,0.6,38,53,0.72,68,83,151,16,12,16,47,68,238,0.62,19.72
Mario Stojic,33,494,42,116,20,62,0.32,22,54,0.41,0.45,13,22,0.59,15,31,46,27,22,3,30,61,117,0.47,19.27
Marios Batis,15,275,18,38,10,29,0.34,8,9,0.89,0.61,7,11,0.64,3,21,24,17,20,3,24,39,53,0.62,35.91
Marius Grigonis,44,964,126,274,51,121,0.42,75,153,0.49,0.55,108,118,0.89,16,83,99,86,25,1,59,116,411,0.63,15.33
Mark Brisker,11,130,19,37,16,29,0.55,3,8,0.38,0.73,8,9,0.89,0,8,8,2,2,0,1,17,62,0.76,2.38
Mark Dickel,12,166,5,18,2,12,0.17,3,6,0.5,0.33,3,4,0.75,4,12,16,23,7,1,16,26,15,0.38,44.74
Mark Miller,17,347,43,112,10,38,0.26,33,74,0.45,0.43,38,51,0.74,17,18,35,23,26,0,29,40,134,0.5,17.74
Mark Payne,16,245,19,43,2,10,0.2,17,33,0.52,0.47,14,19,0.76,8,26,34,15,8,1,14,22,54,0.53,21.42
Markel Brown,20,349,34,98,14,54,0.26,20,44,0.45,0.42,15,23,0.65,11,22,33,38,7,4,16,25,97,0.45,12.89
Marko Antonijevic,13,290,28,79,16,41,0.39,12,38,0.32,0.46,27,33,0.82,3,13,16,33,19,0,26,38,99,0.53,21.75
Marko Arapovic,33,586,86,184,16,61,0.26,70,123,0.57,0.51,26,38,0.68,45,68,113,26,9,4,30,74,214,0.53,13.0
Marko Banic,20,504,105,168,1,5,0.2,104,163,0.64,0.63,54,68,0.79,31,48,79,13,7,1,31,46,265,0.67,13.54
Marko Bulic,2,54,8,18,6,12,0.5,2,6,0.33,0.61,1,2,0.5,1,2,3,5,1,0,2,6,23,0.61,9.58
Marko Cakarevic,17,174,7,26,3,11,0.27,4,15,0.27,0.33,8,8,1.0,12,29,41,14,3,2,18,33,25,0.42,37.88
Marko Guduric,125,2313,319,660,140,346,0.4,179,314,0.57,0.59,195,231,0.85,51,172,223,243,90,11,175,275,973,0.64,18.68
Marko Jaric,67,1683,241,538,50,170,0.29,191,368,0.52,0.49,124,189,0.68,51,173,224,138,118,10,134,164,656,0.53,17.74
Marko Keselj,26,366,37,87,20,60,0.33,17,27,0.63,0.54,7,13,0.55,5,35,40,6,9,3,11,47,101,0.54,10.61
Marko Kuridza,8,139,13,32,1,8,0.12,12,24,0.5,0.42,4,8,0.5,6,17,23,8,0,6,8,15,31,0.44,18.38
Marko Maravic,17,576,54,125,15,35,0.43,39,90,0.43,0.49,57,73,0.78,34,53,87,23,19,0,18,55,180,0.57,10.28
Marko Milic,79,1996,367,708,11,45,0.24,356,663,0.54,0.53,166,268,0.63,182,213,395,148,121,4,169,239,911,0.55,16.99
Marko Pesic,33,959,104,253,42,126,0.33,62,127,0.49,0.49,73,104,0.72,9,57,66,73,25,3,67,100,323,0.54,18.32
Marko Popovic,111,2899,440,1006,230,607,0.38,210,399,0.53,0.55,357,434,0.82,41,147,188,324,133,1,214,274,1467,0.61,15.17
Marko Scekic,15,276,50,92,6,14,0.43,44,78,0.56,0.58,16,26,0.65,19,34,53,15,10,2,20,43,122,0.59,16.2
Marko Simonovic,67,1534,216,472,114,285,0.4,102,187,0.55,0.58,81,100,0.76,45,143,188,34,46,8,39,103,627,0.61,7.03
Marko Tejic,28,214,13,43,4,17,0.24,9,26,0.35,0.35,5,14,0.35,12,23,35,18,3,3,9,53,35,0.36,15.47
Marko Todorovic,35,390,44,85,1,8,0.12,43,77,0.56,0.52,35,52,0.66,41,58,99,18,13,21,26,60,124,0.57,19.42
Marko Tomas,73,1629,189,482,92,261,0.35,97,221,0.44,0.49,147,186,0.78,52,122,174,91,59,5,95,167,617,0.55,14.42
Marko Tusek,59,1382,191,451,67,195,0.34,124,256,0.48,0.5,91,129,0.74,96,138,234,41,33,8,66,112,540,0.53,11.5
Marko Verginella,2,20,2,5,0,3,0.0,2,2,1.0,0.4,2,2,1.0,1,2,3,1,1,0,2,2,6,0.51,25.38
Marlon Garnett,20,588,78,189,45,109,0.41,33,80,0.41,0.53,41,46,0.89,6,49,55,19,19,1,28,28,242,0.58,11.8
Marque Perry,26,537,67,156,14,41,0.34,53,115,0.46,0.47,48,59,0.9,10,40,50,43,13,1,46,43,196,0.54,20.18
Marques Green,26,673,53,149,31,92,0.34,22,57,0.39,0.46,13,19,0.6,5,44,49,77,48,0,44,53,150,0.48,21.85
Martin Henlan,10,153,12,35,3,9,0.33,9,26,0.35,0.39,6,6,1.0,13,20,33,1,6,4,8,20,33,0.44,17.53
Martin Hermannsson,27,696,111,271,29,86,0.34,82,185,0.44,0.46,43,50,0.86,9,34,43,130,13,1,73,58,294,0.5,19.95
Martin Mihajlovic,7,66,7,15,0,1,0.0,7,14,0.5,0.47,3,4,0.75,6,5,11,3,1,2,3,14,17,0.51,15.18
Martin Muursepp,41,786,122,257,30,90,0.33,92,167,0.55,0.53,65,113,0.57,60,103,163,33,31,8,57,129,339,0.55,15.67
Martin Rancik,21,470,79,164,11,27,0.41,68,137,0.5,0.52,23,32,0.86,36,65,101,6,15,12,14,61,192,0.54,7.29
Marton Bader,31,785,96,189,8,25,0.32,88,164,0.54,0.53,71,103,0.69,67,113,180,20,14,20,29,93,271,0.58,11.01
Marty Conlon,12,322,58,107,2,7,0.29,56,100,0.56,0.55,41,49,0.84,28,44,72,19,7,1,22,35,159,0.62,14.61
Martynas Andriuskevicius,15,131,8,23,1,4,0.25,7,19,0.37,0.37,5,16,0.31,5,12,17,4,6,9,12,27,22,0.37,28.54
Martynas Arlauskas,4,13,0,2,0,1,0.0,0,1,0.0,0.0,4,5,0.8,1,1,2,0,0,0,0,3,4,0.48,0.0
Martynas Gecevicius,86,1617,202,456,117,283,0.41,85,173,0.49,0.57,106,125,0.85,21,128,149,112,49,1,98,113,627,0.61,16.09
Martynas Mazeika,9,208,15,58,5,24,0.21,10,34,0.29,0.3,20,28,0.71,2,14,16,17,6,1,9,18,55,0.39,11.35
Martynas Pocius,116,2150,276,698,106,339,0.31,170,359,0.47,0.47,189,248,0.79,52,183,235,168,39,11,170,205,847,0.52,17.4
Marvin O'Connor,10,144,17,49,2,11,0.18,15,38,0.39,0.37,5,9,0.56,4,12,16,10,6,0,12,17,41,0.39,18.47
Marvin Ogunsipe,10,62,4,11,0,3,0.0,4,8,0.5,0.36,1,2,0.5,2,5,7,1,2,0,4,13,9,0.38,25.19
Mason Rocca,10,219,24,53,0,1,0.0,24,52,0.46,0.45,16,27,0.59,20,27,47,2,7,0,13,36,64,0.49,16.69
Massimo Bulleri,126,2665,377,863,128,368,0.35,249,495,0.5,0.51,212,258,0.83,42,182,224,219,138,7,250,295,1094,0.56,20.38
Massimo Chessa,4,40,6,12,4,7,0.57,2,5,0.4,0.67,6,8,0.75,0,0,0,3,4,1,0,5,22,0.71,0.0
Massimo Ruggeri,9,97,12,32,4,18,0.22,8,14,0.57,0.44,10,15,0.67,3,14,17,2,4,1,8,14,38,0.49,17.17
Matej Mamic,45,1191,125,265,41,126,0.33,84,139,0.6,0.55,73,108,0.69,83,139,222,56,50,6,40,118,364,0.58,11.35
Mateusz Ponitka,38,975,140,283,27,88,0.31,113,195,0.58,0.54,65,103,0.59,63,133,196,59,36,8,74,63,372,0.57,18.39
Mathias Lessort,30,633,100,182,0,1,0.0,100,181,0.55,0.55,55,87,0.63,86,84,170,23,25,22,52,85,255,0.58,19.1
Mathieu Wojciechowski,6,42,1,6,0,4,0.0,1,2,0.5,0.17,4,4,1.0,3,4,7,3,0,1,4,7,6,0.39,34.01
Matjaz Smodis,168,3750,623,1260,194,490,0.4,429,770,0.56,0.57,378,486,0.78,211,473,684,133,146,61,240,444,1818,0.62,14.0
Matt Gatens,8,118,13,30,8,19,0.42,5,11,0.45,0.57,4,5,0.8,4,9,13,9,3,0,7,9,38,0.59,17.86
Matt Howard,7,103,8,24,1,5,0.2,7,19,0.37,0.35,10,14,0.83,8,11,19,2,7,0,7,6,27,0.45,18.84
Matt Janning,152,3400,427,1062,261,705,0.37,166,357,0.46,0.52,102,126,0.82,53,232,285,238,104,14,146,295,1217,0.54,11.56
Matt Lojeski,143,3027,459,920,182,427,0.43,277,493,0.56,0.6,143,181,0.81,95,353,448,210,74,25,126,213,1243,0.62,11.19
Matt Nielsen,61,1197,156,340,18,69,0.26,138,271,0.51,0.49,121,166,0.69,58,169,227,85,44,18,89,144,451,0.55,17.73
Matt Walsh,15,438,66,151,29,83,0.35,37,68,0.54,0.53,40,48,0.91,13,63,76,34,14,1,35,39,201,0.58,16.9
Matteo Malaventura,35,638,52,150,31,94,0.33,21,56,0.38,0.45,21,23,0.91,12,30,42,23,16,0,15,67,156,0.49,8.57
Matteo Soragna,59,1551,162,367,64,173,0.37,98,194,0.51,0.53,63,85,0.75,12,134,146,102,58,4,77,136,451,0.56,16.0
Matthew Strazel,16,223,21,53,12,29,0.41,9,24,0.38,0.51,10,13,0.77,2,9,11,25,3,0,19,27,64,0.54,24.45
Maurice Bailey,12,274,35,93,11,43,0.26,24,50,0.48,0.44,28,33,0.85,4,13,17,26,21,1,30,25,109,0.51,21.82
Maurice Baker,9,149,9,25,1,5,0.2,8,20,0.4,0.38,7,7,1.0,2,9,11,9,10,0,17,27,26,0.46,37.71
Maurice Carter,4,74,7,21,0,3,0.0,7,18,0.39,0.33,3,4,0.75,2,5,7,0,5,0,7,6,17,0.37,23.52
Maurice Evans,37,1183,221,470,55,152,0.36,166,318,0.52,0.53,108,151,0.71,49,124,173,44,39,13,77,115,605,0.56,12.55
Maurice Ndour,26,391,65,111,4,10,0.4,61,101,0.6,0.6,29,36,0.81,20,42,62,11,23,9,17,61,163,0.64,11.82
Maurice Taylor,4,56,7,21,0,4,0.0,7,17,0.41,0.33,1,2,0.5,6,7,13,1,1,0,6,9,15,0.34,21.52
Mauro Sartori,12,191,29,66,17,46,0.37,12,20,0.6,0.57,11,14,0.79,6,20,26,6,4,0,7,31,86,0.6,8.84
Maxim Grigoryev,12,78,6,23,1,13,0.08,5,10,0.5,0.28,12,16,0.75,0,3,3,5,3,0,7,10,25,0.42,18.9
Maxim Sheleketo,4,24,1,2,0,1,0.0,1,1,1.0,0.5,2,4,0.5,2,3,5,2,1,1,0,1,4,0.53,0.0
Mehmet Okur,20,544,81,180,14,36,0.39,67,144,0.47,0.49,65,87,0.75,48,83,131,18,20,16,33,62,241,0.55,13.13
Mehmet Yagmur,13,180,24,53,8,26,0.31,16,27,0.59,0.53,5,9,0.56,2,11,13,21,5,1,11,19,61,0.54,16.19
Meir Tapiro,10,167,19,50,0,9,0.0,19,41,0.46,0.38,11,12,0.92,6,11,17,11,9,0,11,25,49,0.44,16.6
Melih Mahmutoglu,133,1624,217,484,138,315,0.44,79,169,0.47,0.59,45,49,0.86,18,85,103,64,34,1,34,184,617,0.61,6.3
Melvin Booker,71,2313,344,786,99,306,0.32,245,480,0.51,0.5,206,255,0.82,30,166,196,234,86,2,139,202,993,0.55,13.4
Melvin Sanders,18,328,51,118,26,67,0.39,25,51,0.49,0.54,10,15,0.69,13,39,52,11,22,2,21,34,138,0.55,14.42
Mert Akay,7,77,7,17,2,8,0.25,5,9,0.56,0.47,5,9,0.56,3,5,8,11,3,0,8,17,21,0.5,27.62
Metin Turen,4,29,3,8,2,4,0.5,1,4,0.25,0.5,4,4,1.0,0,2,2,2,1,0,1,2,12,0.61,9.29
Micah Downs,5,124,18,36,6,15,0.4,12,21,0.57,0.58,10,12,0.83,5,13,18,11,6,5,11,14,52,0.63,21.04
Michael Andersen,26,568,94,164,1,4,0.25,93,160,0.58,0.58,39,74,0.48,49,71,120,13,22,7,42,83,228,0.58,17.61
Michael Bauer,12,227,40,79,17,44,0.39,23,35,0.66,0.61,17,23,0.74,7,31,38,16,6,18,19,34,114,0.64,17.57
Michael Bradley,7,117,21,40,0,4,0.0,21,36,0.58,0.52,7,8,0.88,12,22,34,5,1,3,8,18,49,0.56,15.53
Michael Bramos,57,1341,145,343,90,245,0.37,55,98,0.56,0.55,34,53,0.64,38,149,187,61,31,11,46,115,414,0.57,11.16
Michael Hawkins,20,581,62,160,29,94,0.31,33,66,0.5,0.48,44,53,0.86,10,36,46,82,25,0,56,50,197,0.54,23.4
Michael Kuebler,8,56,8,21,4,10,0.4,4,11,0.36,0.48,3,4,0.75,0,3,3,1,1,0,5,5,23,0.51,18.01
Michael Roll,86,1998,281,601,105,251,0.42,176,350,0.5,0.55,72,81,0.89,37,157,194,208,45,4,86,149,739,0.58,11.9
Michal Chylinski,13,216,28,58,15,32,0.47,13,26,0.5,0.61,4,4,1.0,3,10,13,21,3,0,16,22,75,0.63,21.12
Michal Ignerski,13,237,19,51,7,22,0.32,12,29,0.41,0.44,3,4,0.75,8,29,37,6,7,0,10,26,48,0.45,15.93
Michalis Kakiouzis,143,3363,530,1073,110,339,0.32,420,734,0.57,0.55,290,385,0.76,236,479,715,92,139,22,139,289,1460,0.59,10.06
Michalis Pelekanos,105,1787,164,398,64,194,0.33,100,204,0.49,0.49,76,104,0.75,52,175,227,66,102,33,89,253,468,0.53,16.71
Michel Morandais,28,617,82,203,27,94,0.29,55,109,0.5,0.47,39,53,0.7,21,81,102,24,25,9,42,59,230,0.51,15.65
Michele Maggioli,19,310,34,68,3,8,0.38,31,60,0.52,0.52,1,1,1.0,26,46,72,15,7,13,13,52,72,0.53,15.96
Mickael Gelabale,51,1289,166,305,32,83,0.39,134,222,0.6,0.6,93,115,0.82,82,125,207,49,36,22,53,105,457,0.64,12.97
Mickael Pietrus,27,613,71,188,36,110,0.33,35,78,0.45,0.47,38,62,0.61,21,63,84,37,25,18,37,75,216,0.5,14.67
Miha Zupan,23,426,57,137,19,54,0.35,38,83,0.46,0.49,20,30,0.62,37,49,86,13,13,4,25,58,153,0.51,14.27
Mihajlo Andric,16,174,9,21,4,14,0.29,5,7,0.71,0.52,4,4,1.0,3,7,10,10,6,0,4,21,26,0.57,14.95
Mike Batiste,237,4967,987,1751,39,138,0.28,948,1613,0.59,0.57,481,648,0.75,347,770,1117,128,184,76,370,523,2494,0.61,15.38
Mike Hall,26,730,71,189,34,101,0.34,37,88,0.42,0.47,24,26,0.89,39,77,116,30,24,2,34,66,200,0.5,14.5
Mike James,140,3616,743,1707,247,723,0.34,496,984,0.5,0.51,441,546,0.79,71,337,408,544,132,10,269,261,2174,0.56,12.14
Mike Nahar,11,103,11,31,2,5,0.4,9,26,0.35,0.39,3,4,0.75,3,19,22,1,1,1,8,17,27,0.41,19.63
Mike Nardi,4,27,3,7,1,4,0.25,2,3,0.67,0.5,3,3,1.0,0,1,1,0,0,0,2,5,10,0.6,19.38
Mike Tobey,21,320,66,128,12,39,0.31,54,89,0.61,0.56,27,38,0.71,34,56,90,13,10,10,17,46,171,0.59,10.51
Mike Wilkinson,35,959,128,278,29,87,0.33,99,191,0.52,0.51,51,72,0.62,61,128,189,33,47,23,37,91,336,0.54,10.67
Mike Wilks,9,119,10,34,2,5,0.4,8,29,0.28,0.32,8,11,0.73,3,5,8,4,8,0,13,13,30,0.39,25.08
Mikhail Kulagin,23,137,24,56,16,38,0.42,8,18,0.44,0.57,7,9,0.77,1,3,4,15,5,1,12,23,71,0.59,16.68
Mikhail Mikhailov,19,485,104,172,1,2,0.5,103,170,0.61,0.61,27,60,0.45,39,92,131,26,19,31,27,57,236,0.59,11.98
Milan Gurovic,49,1240,181,480,88,256,0.34,93,224,0.42,0.47,168,204,0.81,51,129,180,36,35,3,64,88,618,0.54,10.1
Milan Macvan,82,1678,242,490,51,144,0.35,191,346,0.55,0.55,131,163,0.82,134,236,370,106,36,12,72,132,666,0.59,11.36
Milan Majstorovic,10,221,22,55,6,25,0.24,16,30,0.53,0.45,17,20,0.85,15,38,53,6,10,9,10,31,67,0.53,13.55
Milan Tomic,66,1541,155,447,90,289,0.31,65,158,0.41,0.45,117,148,0.8,12,93,105,121,42,1,70,157,517,0.5,12.03
Milenko Tepic,118,2529,247,636,85,257,0.33,162,379,0.43,0.46,128,175,0.79,56,229,285,206,85,6,183,233,707,0.5,20.42
Milenko Topic,9,278,50,84,14,32,0.44,36,52,0.69,0.68,16,17,0.94,12,50,62,26,11,4,21,23,130,0.71,18.67
Miljan Goljovic,39,775,126,275,53,130,0.41,73,145,0.5,0.55,52,66,0.77,21,76,97,28,26,3,48,103,357,0.59,13.63
Milko Bjelica,194,3911,597,1340,126,413,0.31,471,927,0.51,0.49,345,460,0.78,215,423,638,215,86,43,211,447,1665,0.54,12.03
Milos Teodosic,237,6125,883,2044,471,1252,0.38,412,792,0.52,0.55,570,650,0.88,66,507,573,1125,193,11,573,558,2807,0.6,19.74
Milos Vujanic,101,2574,423,959,190,514,0.37,233,445,0.52,0.54,375,463,0.79,43,141,184,199,100,3,197,263,1411,0.61,14.49
Milt Palacio,23,688,101,235,18,67,0.27,83,168,0.49,0.47,67,86,0.78,7,54,61,75,29,2,78,50,287,0.53,22.23
Mindaugas Budzinauskas,8,152,9,29,7,21,0.33,2,8,0.25,0.43,13,16,0.81,9,8,17,2,5,0,9,20,38,0.53,19.98
Mindaugas Girdziunas,10,167,14,45,2,18,0.11,12,27,0.44,0.33,13,13,1.0,3,11,14,20,2,0,12,14,43,0.42,19.13
Mindaugas Katelynas,37,571,65,153,15,46,0.33,50,107,0.47,0.47,31,47,0.62,43,87,130,24,17,7,29,81,176,0.51,14.31
Mindaugas Kuzminskas,164,2734,472,986,121,340,0.36,351,646,0.54,0.54,254,320,0.75,218,264,482,123,88,32,162,221,1319,0.59,12.57
Mindaugas Lukauskis,49,1051,112,265,49,143,0.34,63,122,0.52,0.52,59,81,0.73,30,102,132,89,68,4,58,97,332,0.55,16.17
Mindaugas Timinskas,80,2044,230,519,58,171,0.34,172,348,0.49,0.5,180,229,0.8,93,255,348,131,92,22,148,257,698,0.56,19.28
Mindaugas Zukauskas,92,1826,174,360,98,211,0.46,76,149,0.51,0.62,85,104,0.81,69,121,190,108,95,8,84,268,531,0.65,17.15
Mire Chatman,29,921,134,323,36,118,0.31,98,205,0.48,0.47,89,122,0.73,36,94,130,126,58,3,84,57,393,0.52,18.23
Miro Bilan,34,878,181,331,3,10,0.3,178,321,0.55,0.55,75,115,0.67,78,135,213,61,20,7,65,85,440,0.58,14.55
Miroslav Beric,25,671,86,201,42,106,0.4,44,95,0.46,0.53,82,107,0.72,6,31,37,45,13,0,50,64,296,0.6,16.77
Miroslav Raduljica,29,451,90,174,0,1,0.0,90,173,0.52,0.52,54,67,0.81,35,58,93,27,18,1,55,70,234,0.57,21.28
Miroslav Raicevic,10,148,22,38,6,18,0.33,16,20,0.8,0.66,8,11,0.73,7,12,19,2,5,1,12,20,58,0.68,21.88
Miroslav Todic,17,250,31,85,11,38,0.29,20,47,0.43,0.43,12,20,0.75,27,37,64,9,9,2,12,30,85,0.45,11.34
Mirsad Turkcan,128,3642,534,1124,114,328,0.35,420,796,0.53,0.53,344,474,0.74,384,901,1285,183,142,74,272,288,1526,0.57,16.95
Mirza Sarajlija,6,118,12,35,5,18,0.28,7,17,0.41,0.41,10,13,0.77,4,6,10,7,9,0,13,18,39,0.48,24.2
Mirza Teletovic,120,3224,521,1156,263,649,0.41,258,507,0.51,0.56,178,248,0.73,133,379,512,87,61,50,132,255,1483,0.59,9.45
Mithat Demirel,33,569,52,145,23,74,0.31,29,71,0.41,0.44,40,60,0.65,7,31,38,50,17,0,42,90,167,0.49,19.68
Mladen Sekularac,17,333,41,88,8,28,0.29,33,60,0.55,0.51,27,37,0.73,12,40,52,14,8,0,16,36,117,0.56,13.3
Mladjen Sljivancanin,22,438,46,122,33,86,0.38,13,36,0.36,0.51,13,17,0.74,10,21,31,13,25,1,36,51,138,0.53,21.75
Moran Roth,18,110,7,21,3,9,0.33,4,12,0.33,0.4,5,8,0.62,2,9,11,21,4,0,5,20,22,0.45,16.94
Morayo Soluade,4,39,6,16,3,9,0.33,3,7,0.43,0.47,1,2,0.5,2,2,4,3,4,0,1,4,16,0.47,5.59
Morris Finley,33,738,99,224,34,96,0.35,65,128,0.51,0.52,53,60,0.9,14,44,58,67,40,0,49,49,285,0.57,16.37
Mouhammad Faye,12,219,15,46,9,27,0.33,6,19,0.32,0.42,15,18,0.83,12,33,45,7,4,7,9,21,54,0.5,14.3
Mouhammadou Jaiteh,10,126,19,34,0,2,0.0,19,32,0.59,0.56,8,11,0.73,11,26,37,3,4,4,4,18,46,0.59,9.34
Moustapha Sonko,78,1955,186,465,73,220,0.33,113,245,0.46,0.48,139,166,0.83,44,134,178,174,71,25,142,225,584,0.54,20.88
Muhammed Baygul,30,373,45,109,13,39,0.33,32,70,0.46,0.47,26,35,0.62,20,31,51,26,8,0,33,48,129,0.52,20.97
Muratcan Guler,42,582,42,116,17,53,0.32,25,63,0.4,0.44,22,37,0.66,23,58,81,46,26,5,38,51,123,0.46,22.32
Mustafa Abi,65,901,44,108,16,45,0.36,28,63,0.44,0.48,25,44,0.57,8,67,75,34,22,3,38,143,129,0.51,22.98
Mustafa Shakur,27,514,74,186,10,46,0.22,64,140,0.46,0.42,46,58,0.77,9,42,51,66,24,2,48,62,204,0.48,18.5
Nacho Azofra,24,532,41,98,30,72,0.42,11,26,0.42,0.57,16,20,0.8,12,39,51,55,32,0,41,62,128,0.6,27.74
Nadav Henefeld,20,454,37,66,0,1,0.0,37,65,0.57,0.56,8,22,0.36,18,43,61,49,27,3,27,72,82,0.54,26.3
Nando De Colo,192,4936,1003,2004,294,682,0.43,709,1322,0.54,0.57,769,818,0.94,85,459,544,669,209,14,476,387,3069,0.65,16.76
Nate Green,18,394,52,131,15,57,0.26,37,74,0.5,0.45,22,36,0.61,5,38,43,35,42,2,33,49,141,0.48,18.35
Nate Huffman,20,528,97,181,6,16,0.38,91,165,0.55,0.55,79,105,0.75,41,107,148,19,13,10,37,53,279,0.61,14.0
Nate Linhart,20,314,44,84,19,44,0.43,25,40,0.62,0.64,8,15,0.53,12,43,55,22,18,6,9,42,115,0.63,9.04
Nate Wolters,70,1338,253,529,54,151,0.36,199,378,0.53,0.53,59,86,0.66,17,146,163,205,47,1,87,126,619,0.55,13.31
Nathan Erdmann,12,282,31,85,16,44,0.36,15,41,0.37,0.46,11,13,0.85,6,26,32,22,18,2,18,36,89,0.49,16.56
Nebojsa Bogavac,22,489,53,121,31,75,0.41,22,46,0.48,0.57,24,26,0.89,6,41,47,26,18,0,28,36,161,0.61,17.45
Nedzad Sinanovic,13,137,16,33,1,1,1.0,15,32,0.47,0.5,11,13,0.85,8,22,30,2,4,6,15,19,44,0.57,27.92
Nemanja Aleksandrov,7,73,5,24,2,13,0.15,3,11,0.27,0.25,6,6,1.0,3,15,18,1,6,2,4,8,18,0.34,13.05
Nemanja Bezbradica,15,57,4,10,1,3,0.33,3,7,0.43,0.45,1,2,0.5,3,6,9,0,2,2,5,4,10,0.46,31.49
Nemanja Bjelica,102,2264,337,708,110,307,0.36,227,401,0.57,0.55,137,190,0.7,133,428,561,159,103,40,114,238,921,0.58,12.59
Nemanja Dangubic,114,1902,205,476,82,213,0.38,123,263,0.47,0.52,86,113,0.76,60,203,263,84,52,13,112,273,578,0.55,17.56
Nemanja Djurisic,9,148,19,45,3,8,0.38,16,37,0.43,0.46,4,6,0.67,15,15,30,5,3,1,9,22,45,0.47,15.89
Nemanja Gordic,67,1511,178,468,62,184,0.34,116,284,0.41,0.45,60,80,0.77,16,85,101,227,48,0,130,158,478,0.47,20.53
Nemanja Jaramaz,10,244,28,72,13,34,0.38,15,38,0.39,0.48,26,30,0.87,9,20,29,29,3,1,8,16,95,0.56,8.58
Nemanja Jelesijevic,7,42,5,14,0,3,0.0,5,11,0.45,0.36,5,8,0.62,1,6,7,1,1,3,7,6,15,0.43,28.55
Nemanja Nedovic,94,1911,346,841,149,427,0.35,197,414,0.48,0.5,178,219,0.82,29,124,153,267,53,11,170,173,1019,0.54,15.35
Nenad Canak,28,683,83,199,31,72,0.43,52,127,0.41,0.49,44,61,0.72,15,62,77,12,32,1,34,102,241,0.53,13.08
Nenad Krstic,80,1721,313,572,4,8,0.5,309,564,0.55,0.55,208,302,0.67,95,209,304,58,26,53,83,169,838,0.59,10.53
Nenad Markovic,30,739,99,234,48,129,0.37,51,105,0.49,0.53,82,101,0.81,7,54,61,39,24,4,39,78,328,0.59,12.29
Nenad Stefanovic,8,29,2,6,1,3,0.33,1,3,0.33,0.42,4,8,0.5,0,0,0,4,1,0,0,9,9,0.47,0.0
Nestoras Komatos,27,323,42,85,15,41,0.37,27,44,0.61,0.58,14,26,0.52,13,39,52,10,14,5,9,52,113,0.59,8.54
Nick Calathes,211,5610,838,1942,184,656,0.28,654,1286,0.51,0.48,262,473,0.55,122,645,767,1258,298,21,472,507,2122,0.49,18.0
Nicolas Batum,31,734,89,198,17,57,0.3,72,141,0.51,0.49,62,81,0.75,26,79,105,74,38,15,68,58,257,0.55,22.54
Nicolas Fernandez,8,106,12,25,2,4,0.5,10,21,0.48,0.52,5,10,0.5,1,12,13,1,4,8,13,26,31,0.53,30.66
Nicolas Gianella,5,85,9,24,1,7,0.14,8,17,0.47,0.4,3,4,0.75,4,3,7,5,2,0,4,15,22,0.43,13.44
Nicolas Lang,8,123,12,36,8,24,0.33,4,12,0.33,0.44,5,6,0.83,1,11,12,3,2,0,8,15,37,0.48,17.15
Nicolas Laprovittola,37,440,51,140,20,77,0.26,31,63,0.49,0.44,31,36,0.85,8,36,44,99,12,0,58,61,153,0.49,27.12
Nicolas Mazzarino,26,467,40,107,24,73,0.33,16,34,0.47,0.49,22,26,0.92,4,20,24,30,7,0,20,54,126,0.53,14.45
Nicolo Melli,207,4870,550,1180,179,462,0.39,371,718,0.52,0.54,252,327,0.72,240,732,972,306,167,103,206,532,1531,0.58,13.47
Niels Giffey,52,893,134,285,51,115,0.44,83,170,0.49,0.56,44,57,0.63,36,83,119,40,34,11,52,121,363,0.59,14.36
Nigel Hayes,28,624,61,151,29,78,0.37,32,73,0.44,0.5,25,33,0.76,31,68,99,27,10,6,15,54,176,0.53,8.31
Nigel Williams-Goss,30,788,102,252,30,81,0.37,72,171,0.42,0.46,43,52,0.83,12,49,61,125,21,1,43,65,277,0.5,13.53
Nihad Dedovic,64,1532,241,540,70,219,0.32,171,321,0.53,0.51,104,123,0.85,41,124,165,161,60,3,87,135,656,0.55,12.77
Nihad Djedovic,56,1407,204,472,42,140,0.3,162,332,0.49,0.48,99,128,0.79,40,147,187,129,63,8,137,129,549,0.52,20.59
Nik Caner-Medley,44,860,126,279,39,96,0.41,87,183,0.48,0.52,55,72,0.76,52,116,168,30,27,17,36,42,346,0.56,10.38
Nik Stauskas,22,452,67,161,38,90,0.42,29,71,0.41,0.53,25,32,0.78,9,38,47,35,12,4,28,39,197,0.56,13.79
Nikita Kurbanov,228,3622,352,734,114,289,0.39,238,445,0.53,0.56,247,291,0.83,202,507,709,208,125,61,160,440,1065,0.62,15.65
Nikita Morgunov,8,204,23,55,4,17,0.24,19,38,0.5,0.45,9,15,0.6,7,30,37,7,5,10,8,18,59,0.48,11.49
Nikita Shabalkin,2,16,2,5,0,1,0.0,2,4,0.5,0.4,2,2,1.0,2,1,3,0,0,0,3,3,6,0.51,33.78
Niklas Lutcke,8,168,13,43,6,24,0.25,7,19,0.37,0.37,2,3,0.67,7,8,15,12,8,0,4,19,34,0.38,8.28
Nikola Ivanovic,8,157,19,50,9,27,0.33,10,23,0.43,0.47,9,11,0.82,7,8,15,29,7,0,7,14,56,0.51,11.32
Nikola Jovanovic,16,129,25,46,1,3,0.33,24,43,0.56,0.55,6,18,0.33,21,23,44,3,1,3,4,19,57,0.53,6.91
Nikola Kalinic,166,3783,438,952,116,341,0.34,322,611,0.53,0.52,224,296,0.77,129,369,498,261,115,34,224,380,1216,0.56,17.15
Nikola Loncar,23,479,70,190,38,111,0.34,32,79,0.41,0.47,28,37,0.76,6,33,39,24,20,2,34,33,206,0.5,14.15
Nikola Milutinov,64,1186,188,297,1,2,0.5,187,295,0.63,0.63,110,153,0.71,157,180,337,63,29,49,72,120,487,0.67,16.5
Nikola Mirotic,124,2918,516,1047,151,404,0.37,365,643,0.57,0.56,396,463,0.86,172,456,628,136,108,76,166,242,1579,0.63,11.72
Nikola Pekovic,20,278,35,60,0,1,0.0,35,59,0.59,0.58,25,35,0.71,22,29,51,4,11,6,21,71,95,0.63,21.78
Nikola Prkacin,121,2939,451,835,4,19,0.21,447,816,0.55,0.54,330,472,0.7,161,423,584,225,169,38,296,409,1236,0.59,22.11
Nikola Radicevic,23,348,33,97,8,35,0.23,25,62,0.4,0.38,34,42,0.81,5,27,32,72,9,0,34,57,108,0.47,22.75
Nikola Radulovic,22,504,58,142,24,72,0.33,34,70,0.49,0.49,40,48,0.86,26,48,74,31,18,8,26,67,180,0.55,13.75
Nikola Rebic,15,119,11,35,5,22,0.23,6,13,0.46,0.39,3,8,0.38,4,12,16,13,4,1,9,16,30,0.39,18.94
Nikola Vujcic,190,4945,926,1740,78,224,0.35,848,1516,0.56,0.55,510,734,0.68,276,760,1036,523,179,122,353,444,2440,0.59,14.61
Nikolaos Bountouris,44,559,31,81,17,54,0.31,14,27,0.52,0.49,27,38,0.6,12,24,36,49,31,3,24,92,106,0.54,19.72
Nikolaos Oikonomou,24,484,61,134,29,62,0.47,32,72,0.44,0.56,59,75,0.78,19,43,62,30,15,1,31,54,210,0.63,15.66
Nikolaos Papanikolopoulos,3,29,2,7,1,6,0.17,1,1,1.0,0.36,2,2,1.0,1,1,2,1,0,0,3,5,7,0.44,27.57
Nikoloz Tskitishvili,6,36,3,8,0,2,0.0,3,6,0.5,0.38,0,2,0.0,4,3,7,2,1,1,1,6,6,0.34,10.12
Nikos Argyropoulos,3,9,0,2,0,1,0.0,0,1,0.0,0.0,2,2,1.0,1,0,1,0,1,0,0,0,2,0.35,0.0
Nikos Barlos,39,493,47,136,19,65,0.29,28,71,0.39,0.42,37,55,0.72,29,78,107,22,28,3,31,90,150,0.47,16.21
Nikos Hatzis,101,2145,290,714,130,348,0.37,160,366,0.44,0.5,237,289,0.83,39,155,194,128,62,0,97,197,947,0.56,10.34
Nikos Hatzivrettas,141,2917,347,720,132,336,0.39,215,384,0.56,0.57,257,331,0.78,45,189,234,133,80,13,121,340,1083,0.63,12.26
Nikos Pappas,130,2121,296,693,92,291,0.32,204,402,0.51,0.49,227,281,0.78,35,141,176,146,80,6,130,235,911,0.56,13.73
Nikos Zisis,308,7008,735,1757,182,580,0.31,553,1177,0.47,0.47,484,613,0.78,104,535,639,885,174,3,392,687,2136,0.53,16.21
Nobel Boungou Colo,20,551,65,168,23,74,0.31,42,94,0.45,0.46,35,43,0.82,20,39,59,52,23,6,43,41,188,0.5,18.7
Noel Felix,12,84,11,22,0,2,0.0,11,20,0.55,0.5,12,16,0.75,2,11,13,1,1,4,9,32,34,0.59,23.66
Nolan Smith,1,16,2,9,0,1,0.0,2,8,0.25,0.22,2,2,1.0,1,2,3,1,0,0,2,2,6,0.3,16.84
Norbert Valis,9,122,12,23,3,9,0.33,9,14,0.64,0.59,6,9,0.67,2,16,18,7,3,0,15,35,33,0.61,35.75
Norman Nolan,3,46,6,23,1,3,0.33,5,20,0.25,0.28,4,5,0.8,2,5,7,1,5,2,6,9,17,0.34,19.23
Norris Cole,43,1088,232,519,41,119,0.34,191,400,0.48,0.49,97,117,0.84,10,99,109,175,42,2,106,115,602,0.53,15.67
Novica Velickovic,120,2072,292,655,63,203,0.31,229,452,0.51,0.49,127,201,0.56,139,296,435,129,68,26,147,233,774,0.52,16.51
Nuno Manarte,10,234,17,40,1,8,0.12,16,32,0.5,0.44,10,16,0.62,2,19,21,21,16,0,25,27,45,0.48,34.7
Ognjen Askrabic,16,382,48,107,10,27,0.37,38,80,0.48,0.5,18,41,0.44,34,54,88,22,24,10,14,49,124,0.5,10.07
Ognjen Dobric,61,786,112,247,44,131,0.34,68,116,0.59,0.54,33,45,0.61,41,62,103,32,37,8,26,68,301,0.56,8.88
Oguz Savas,84,1439,224,424,12,43,0.28,212,381,0.56,0.54,150,194,0.75,99,178,277,73,42,27,99,166,610,0.6,16.27
Okben Ulubay,2,35,5,9,1,3,0.33,4,6,0.67,0.61,1,2,0.5,4,1,5,2,1,2,1,4,12,0.61,9.19
Oleksiy Pecherov,3,58,12,26,6,17,0.35,6,9,0.67,0.58,5,5,1.0,2,6,8,0,1,2,1,7,35,0.62,3.42
Oliver Lafayette,84,1786,221,618,115,346,0.33,106,272,0.39,0.45,103,138,0.77,41,153,194,230,75,2,131,162,660,0.49,16.18
Olivier Hanlan,24,507,68,181,23,64,0.36,45,117,0.38,0.44,32,45,0.71,13,43,56,39,16,1,30,58,191,0.48,13.0
Omar Cook,87,2451,203,537,124,329,0.38,79,208,0.38,0.49,122,164,0.72,24,153,177,481,117,3,175,204,652,0.54,22.32
Omar Quintero,2,17,7,8,1,1,1.0,6,7,0.86,0.94,3,5,0.6,0,4,4,0,0,0,2,0,18,0.88,16.39
Omer Asik,15,279,44,74,0,1,0.0,44,73,0.6,0.59,29,55,0.53,34,48,82,6,11,31,21,26,117,0.6,17.62
Omer Onan,187,3595,431,1005,164,460,0.36,267,545,0.49,0.51,173,290,0.6,38,161,199,127,142,2,147,414,1199,0.53,11.49
Omri Casspi,45,643,116,217,15,43,0.35,101,174,0.58,0.57,58,89,0.61,34,90,124,38,27,9,40,80,305,0.6,13.51
Onuralp Bitim,4,35,3,5,2,2,1.0,1,3,0.33,0.8,2,2,1.0,1,3,4,2,0,0,5,1,10,0.85,45.96
Oriol Pauli,29,408,57,127,6,42,0.14,51,85,0.6,0.47,32,51,0.63,11,54,65,41,9,5,35,38,152,0.51,18.98
Orlando Johnson,17,281,41,102,17,42,0.4,24,60,0.4,0.49,20,25,0.89,7,29,36,8,5,4,21,34,119,0.53,15.67
Oscar Torres,10,231,31,62,14,29,0.48,17,33,0.52,0.61,11,18,0.61,13,33,46,9,11,1,11,19,87,0.62,13.59
Othello Hunter,102,2000,356,593,1,12,0.08,355,581,0.61,0.6,140,197,0.66,241,325,566,83,62,40,91,232,853,0.63,11.81
Ousmane Camara,10,107,10,27,0,2,0.0,10,25,0.4,0.37,7,9,0.78,14,14,28,1,2,2,9,9,27,0.44,22.52
PJ Tucker,10,231,35,70,0,3,0.0,35,67,0.52,0.5,19,30,0.63,19,44,63,17,4,1,15,22,89,0.53,15.27
Pablo Aguilar,14,112,18,35,6,20,0.3,12,15,0.8,0.6,4,6,0.75,9,19,28,4,5,5,3,8,46,0.61,7.38
Pablo Almazan,4,43,3,6,2,4,0.5,1,2,0.5,0.67,4,4,1.0,1,7,8,3,2,0,3,3,12,0.77,27.88
Pablo Prigioni,183,4580,350,834,223,628,0.36,127,206,0.62,0.55,206,248,0.82,114,339,453,798,320,7,298,385,1129,0.6,24.01
Paccelis Morlende,18,281,29,69,15,37,0.41,14,32,0.44,0.53,17,23,0.74,6,17,23,18,21,2,21,39,90,0.57,20.97
Paco Vazquez,33,572,53,146,42,99,0.42,11,47,0.23,0.51,22,29,0.76,12,28,40,28,29,0,44,75,170,0.54,21.7
Panagiotis Liadelis,42,1293,250,488,26,76,0.34,224,412,0.54,0.54,283,324,0.88,16,87,103,62,39,0,68,89,809,0.64,9.73
Panagiotis Vasilopoulos,93,1636,181,421,74,181,0.41,107,240,0.45,0.52,74,109,0.68,59,233,292,79,56,54,117,268,510,0.54,19.97
Pancho Jasen,13,304,45,108,7,32,0.22,38,76,0.5,0.45,42,61,0.69,25,47,72,27,15,5,25,45,139,0.52,15.64
Papa Dia,7,63,7,15,0,1,0.0,7,14,0.5,0.47,2,2,1.0,5,3,8,2,1,0,6,5,16,0.5,27.42
Pape Badiane,24,497,62,141,2,5,0.4,60,136,0.44,0.45,48,58,0.84,43,67,110,15,18,20,33,38,174,0.52,16.54
Pape Sow,12,230,40,78,0,3,0.0,40,75,0.53,0.51,20,28,0.71,25,34,59,4,12,6,23,45,100,0.55,20.3
Pape-Philippe Amagou,28,512,50,132,25,61,0.41,25,71,0.35,0.47,31,45,0.62,7,25,32,27,15,1,33,62,156,0.51,17.86
Pascal Roller,28,975,106,287,61,166,0.37,45,121,0.37,0.48,48,60,0.81,21,46,67,91,32,1,79,63,321,0.51,20.13
Pat Burke,34,684,119,234,3,13,0.23,116,221,0.52,0.51,42,61,0.69,62,124,186,17,17,13,68,79,283,0.54,20.68
Pat Calathes,15,179,25,49,13,24,0.54,12,25,0.48,0.64,5,9,0.56,5,19,24,11,8,1,10,20,68,0.64,15.88
Patric Young,47,704,88,157,0,2,0.0,88,155,0.57,0.56,54,89,0.61,66,115,181,15,24,24,45,60,230,0.59,18.66
Patricio Garino,51,802,87,196,30,83,0.36,57,113,0.5,0.52,67,79,0.84,24,75,99,27,41,6,35,104,271,0.59,13.17
Patricio Prato,13,114,11,22,3,8,0.38,8,14,0.57,0.57,6,9,0.67,6,16,22,4,14,0,9,21,31,0.6,25.74
Patrick Baldwin,9,288,53,99,9,19,0.47,44,80,0.55,0.58,50,56,0.89,15,17,32,21,26,3,20,28,165,0.67,13.92
Patrick Beverley,19,177,18,35,2,11,0.18,16,24,0.67,0.54,14,17,0.82,11,26,37,11,12,3,10,21,52,0.61,19.05
Patrick Christopher,24,576,74,194,25,70,0.36,49,124,0.4,0.45,28,33,0.85,15,39,54,25,16,6,38,57,201,0.48,15.41
Patrick Femerling,26,362,42,79,1,3,0.33,41,76,0.54,0.54,34,39,0.83,42,50,92,8,16,13,23,56,119,0.62,19.3
Patrick Heckmann,65,808,71,152,30,63,0.48,41,89,0.46,0.57,35,50,0.74,19,79,98,43,19,4,40,102,207,0.59,18.69
Patrick Koller,10,113,3,18,0,9,0.0,3,9,0.33,0.17,3,6,0.5,3,3,6,6,7,0,6,15,9,0.22,22.52
Pau Gasol,6,154,38,57,4,8,0.5,34,49,0.69,0.7,31,42,0.74,10,26,36,4,5,4,10,12,111,0.74,11.7
Pau Ribas,163,2840,314,739,161,417,0.39,153,322,0.48,0.53,100,120,0.77,54,237,291,372,110,3,162,279,889,0.56,16.98
Paul Davis,36,649,168,293,2,2,1.0,166,291,0.57,0.58,88,108,0.77,52,121,173,41,34,29,41,103,426,0.63,10.75
Paul Lacombe,20,402,34,82,5,19,0.26,29,63,0.46,0.45,19,23,0.83,14,47,61,44,20,10,34,47,92,0.5,26.96
Paul Stephan Biligha,13,174,14,38,0,4,0.0,14,34,0.41,0.37,10,11,0.91,14,16,30,5,3,11,8,25,38,0.44,15.74
Paul Stoll,14,221,16,49,13,37,0.35,3,12,0.25,0.46,6,8,0.75,7,21,28,38,14,0,17,26,51,0.49,24.45
Paul Zipser,43,809,103,233,31,83,0.37,72,150,0.48,0.51,74,88,0.93,38,94,132,48,18,19,45,101,311,0.57,14.21
Paulius Jankunas,341,7631,1105,2239,140,477,0.29,965,1762,0.55,0.52,696,885,0.77,516,1300,1816,381,224,99,455,914,3046,0.58,14.76
Paulius Valinskas,30,233,25,65,9,30,0.3,16,35,0.46,0.45,17,22,0.88,5,25,30,22,5,1,15,18,76,0.51,16.73
Pavel Antipov,32,545,58,119,39,78,0.5,19,41,0.46,0.65,11,16,0.82,19,38,57,20,18,5,10,55,166,0.66,7.35
Pavel Korobkov,34,294,38,58,4,10,0.4,34,48,0.71,0.69,17,23,0.73,17,31,48,12,6,11,17,65,97,0.71,19.97
Pawel Kikowski,8,42,2,10,2,9,0.22,0,1,0.0,0.3,3,3,1.0,1,2,3,1,2,0,1,11,9,0.4,8.12
Pedro Llompart,4,60,6,11,3,6,0.5,3,5,0.6,0.68,9,10,0.9,0,3,3,5,0,0,5,6,24,0.78,24.51
Pedro Robles,10,153,30,59,13,29,0.45,17,30,0.57,0.62,7,10,0.7,1,4,5,8,5,0,10,11,80,0.63,13.62
Pep Cargol,12,161,18,37,1,6,0.17,17,31,0.55,0.5,9,12,0.75,7,20,27,5,1,2,7,23,46,0.54,14.2
Pepe Sanchez,105,2104,168,412,62,190,0.33,106,222,0.48,0.48,86,113,0.74,48,251,299,305,138,2,184,232,484,0.52,28.5
Pere Tomas,9,79,7,14,5,8,0.62,2,6,0.33,0.68,2,6,0.33,4,7,11,3,4,1,4,6,21,0.63,19.38
Pero Antic,155,2581,276,775,140,467,0.3,136,308,0.44,0.45,207,289,0.61,139,380,519,116,62,28,120,366,899,0.5,11.74
Pero Dujmovic,20,468,52,120,23,61,0.38,29,59,0.49,0.53,19,24,0.79,9,44,53,16,12,0,19,42,146,0.56,12.7
Petar Arsic,14,224,40,90,6,33,0.18,34,57,0.6,0.48,11,17,0.65,10,34,44,8,9,4,12,34,97,0.5,10.96
Petar Babic,7,84,10,15,6,8,0.75,4,7,0.57,0.87,4,6,0.67,0,4,4,9,4,0,6,15,30,0.85,25.38
Petar Bozic,122,1389,105,296,80,228,0.35,25,68,0.37,0.49,39,54,0.78,32,87,119,99,66,8,96,324,329,0.51,23.09
Petar Naumoski,27,811,114,254,56,139,0.4,58,115,0.5,0.56,90,111,0.82,17,37,54,79,41,0,52,62,374,0.62,14.65
Petar Popovic,21,285,38,83,11,24,0.46,27,59,0.46,0.52,15,20,0.75,5,14,19,25,10,1,15,33,102,0.56,14.04
Pete Mickeal,103,2567,391,795,51,141,0.36,340,654,0.52,0.52,244,279,0.86,101,375,476,78,102,19,124,223,1077,0.59,11.9
Peter Hoffman,3,26,0,6,0,5,0.0,0,1,0.0,0.0,1,2,0.5,0,3,3,1,0,0,1,4,1,0.07,12.69
Peter Lisicky,4,67,6,24,5,12,0.42,1,12,0.08,0.35,10,12,0.83,4,3,7,3,4,0,6,8,27,0.46,17.01
Peter Van Elswyk,4,57,7,12,1,3,0.33,6,9,0.67,0.62,1,2,0.5,5,7,12,2,1,0,2,8,16,0.62,13.44
Petr Gubanov,39,322,19,52,8,24,0.33,11,28,0.39,0.44,10,17,0.55,9,24,33,17,7,4,10,38,56,0.47,14.39
Petr Samoylenko,19,403,29,64,11,39,0.28,18,25,0.72,0.54,9,12,0.75,3,33,36,55,13,0,24,29,78,0.56,25.73
Petteri Koponen,155,2962,443,956,247,535,0.46,196,421,0.47,0.59,146,162,0.9,30,196,226,286,63,4,159,243,1279,0.62,13.4
Peyton Siva,17,360,42,126,20,73,0.27,22,53,0.42,0.41,54,63,0.86,4,21,25,88,16,0,39,42,158,0.51,20.24
Phil Hickey,14,336,36,80,1,3,0.33,35,77,0.45,0.46,13,37,0.35,20,58,78,9,6,5,22,48,86,0.45,18.6
Phil Pressey,18,225,30,74,9,35,0.26,21,39,0.54,0.47,10,15,0.67,0,29,29,37,10,1,18,33,79,0.49,18.26
Phil Ricci,14,267,58,104,4,15,0.27,54,89,0.61,0.58,29,45,0.64,13,29,42,14,10,6,24,27,147,0.59,16.24
Philipp Neumann,6,54,8,13,0,1,0.0,8,12,0.67,0.62,6,8,0.75,5,1,6,1,0,3,5,6,22,0.67,23.23
Philipp Schwethelm,2,14,3,4,2,2,1.0,1,2,0.5,1.0,2,2,1.0,0,0,0,0,1,0,1,0,10,1.02,17.01
Pierre Jackson,35,792,138,339,54,151,0.36,84,188,0.45,0.49,110,130,0.79,12,81,93,131,30,1,82,80,440,0.56,17.15
Pierre Oriola,90,1519,191,360,43,106,0.41,148,254,0.58,0.59,100,152,0.64,102,174,276,58,26,20,54,191,525,0.61,11.23
Pierria Henry,25,616,68,165,18,61,0.3,50,104,0.48,0.47,43,59,0.73,27,63,90,85,40,0,57,49,197,0.52,22.99
Pierric Poupet,14,204,13,38,6,20,0.3,7,18,0.39,0.42,22,27,0.82,7,14,21,18,12,1,24,17,54,0.54,32.49
Pietro Aradori,58,887,118,258,34,85,0.4,84,173,0.49,0.52,91,115,0.8,36,90,126,54,17,1,37,70,361,0.58,10.71
Piotr Szczotka,62,673,40,102,2,13,0.15,38,89,0.43,0.4,9,21,0.43,23,59,82,26,20,2,20,100,91,0.41,15.24
Piotr Szybilski,3,53,7,16,0,2,0.0,7,14,0.5,0.44,5,7,0.71,3,6,9,0,1,1,2,14,19,0.5,9.49
Pooh Jeter,3,45,7,21,1,9,0.11,6,12,0.5,0.36,1,2,0.5,0,1,1,5,1,0,3,4,16,0.37,12.06
Pops Mensah Bonsu,27,457,74,133,0,3,0.0,74,130,0.57,0.56,40,71,0.54,49,80,129,10,14,13,21,56,188,0.57,11.34
Predrag Drobnjak,43,908,148,343,30,87,0.34,118,256,0.46,0.48,98,117,0.55,60,127,187,41,37,24,65,74,424,0.54,14.15
Predrag Materic,14,190,10,23,6,11,0.55,4,12,0.33,0.57,20,24,0.83,4,18,22,5,2,0,16,33,46,0.69,32.28
Predrag Suput,56,1378,197,433,50,145,0.34,147,288,0.51,0.51,76,104,0.75,56,142,198,87,51,7,119,154,520,0.54,19.91
Preston Shumpert,59,1278,191,447,65,180,0.36,126,267,0.47,0.5,49,61,0.82,40,100,140,58,51,4,67,76,496,0.52,12.39
Primoz Brezec,14,265,57,105,1,4,0.25,56,101,0.55,0.55,17,26,0.65,34,28,62,5,9,3,15,42,132,0.57,11.41
Przemyslaw Zamojski,54,893,106,272,61,171,0.36,45,101,0.45,0.5,34,49,0.61,20,56,76,44,23,4,48,81,307,0.52,14.05
Quadre Michael Lollis,62,1865,281,494,15,43,0.35,266,451,0.59,0.58,156,258,0.6,186,327,513,116,68,18,126,225,733,0.6,17.18
Quincy Acy,27,526,48,120,18,69,0.26,30,51,0.59,0.48,16,20,0.8,25,69,94,19,16,22,33,58,130,0.5,20.4
Quincy Lewis,43,1087,171,402,51,163,0.31,120,239,0.5,0.49,84,113,0.74,16,118,134,40,48,22,39,114,477,0.53,7.95
Quincy Miller,28,775,130,281,40,121,0.33,90,160,0.56,0.53,67,85,0.89,28,122,150,25,24,40,51,73,367,0.58,13.81
Quino Colom,51,1150,153,397,61,188,0.32,92,209,0.44,0.46,106,138,0.76,28,110,138,251,31,1,111,43,473,0.52,19.52
Quinton Hosley,13,212,38,82,8,23,0.35,30,59,0.51,0.51,28,39,0.72,17,25,42,7,10,6,19,21,112,0.56,16.08
Qyntel Woods,48,1311,240,503,64,179,0.36,176,324,0.54,0.54,100,130,0.76,43,188,231,78,45,13,118,106,644,0.57,17.4
Rafa Freire,13,159,11,33,1,13,0.08,10,20,0.5,0.35,3,8,0.38,4,14,18,22,9,0,19,27,26,0.36,34.22
Rafa Luz,32,249,29,54,9,18,0.5,20,36,0.56,0.62,4,6,0.67,6,20,26,49,13,1,25,42,71,0.63,30.62
Rafael Hettsheimeir,34,370,53,108,12,30,0.4,41,78,0.53,0.55,26,34,0.78,25,42,67,11,7,8,20,53,144,0.59,13.99
Rafael Martinez,60,1188,142,335,73,195,0.37,69,140,0.49,0.53,92,113,0.78,18,72,90,78,35,1,74,104,449,0.58,16.13
Raimonds Miglieniks,18,270,10,38,7,28,0.25,3,10,0.3,0.36,7,12,0.55,2,15,17,45,13,1,21,32,34,0.39,32.67
Rakim Sanders,57,1249,239,527,78,207,0.38,161,320,0.5,0.53,64,95,0.69,50,136,186,50,64,10,65,153,620,0.55,10.26
Ralph Biggs,14,515,87,177,10,32,0.31,77,145,0.53,0.52,60,75,0.8,14,71,85,45,30,4,31,47,244,0.58,12.86
Ramel Curry,35,603,91,218,41,109,0.38,50,109,0.46,0.51,25,30,0.83,18,57,75,49,27,1,41,39,248,0.54,15.06
Ramon Espuna,8,74,2,8,0,1,0.0,2,7,0.29,0.25,5,8,0.62,3,8,11,1,0,0,1,16,9,0.39,7.99
Ramon Sessions,2,40,6,20,1,6,0.17,5,14,0.36,0.32,5,6,0.83,3,4,7,2,1,0,3,2,18,0.4,11.7
Ramunas Petraitis,7,44,3,7,2,2,1.0,1,5,0.2,0.57,1,6,0.17,1,0,1,1,1,0,4,3,9,0.47,29.33
Ramunas Siskauskas,143,3874,545,1106,210,501,0.42,335,605,0.55,0.59,355,463,0.72,110,313,423,233,153,31,188,278,1655,0.63,12.55
Randy Culpepper,4,83,13,32,4,11,0.36,9,21,0.43,0.47,8,11,0.73,2,9,11,8,7,1,10,9,38,0.52,21.35
Randy Duck,5,186,27,52,9,15,0.6,18,37,0.49,0.61,19,22,0.86,1,9,10,19,3,1,10,19,82,0.66,13.95
Randy Holcomb,7,141,17,44,1,8,0.12,16,36,0.44,0.4,28,38,0.74,6,21,27,4,5,2,16,17,63,0.52,20.86
Randy Oveneke,7,28,4,7,1,3,0.33,3,4,0.75,0.64,1,2,0.5,1,2,3,1,1,0,1,6,10,0.63,11.26
Rashad Wright,25,529,59,140,19,56,0.34,40,84,0.48,0.49,33,55,0.65,14,45,59,42,18,2,35,53,170,0.52,17.57
Rashard Griffith,35,965,155,255,0,2,0.0,155,253,0.61,0.61,86,150,0.54,98,186,284,30,48,39,68,126,396,0.62,17.48
Rashid Atkins,23,518,63,154,20,46,0.43,43,108,0.4,0.47,27,37,0.62,16,34,50,52,38,8,27,40,173,0.51,13.69
Rasho Nesterovic,20,416,94,141,0,2,0.0,94,139,0.68,0.67,30,46,0.65,51,57,108,11,7,20,26,48,218,0.68,13.89
Rasim Basak,40,452,46,112,30,77,0.39,16,35,0.46,0.54,20,25,0.79,15,48,63,10,24,4,19,49,142,0.58,13.38
Ratko Varda,38,681,128,253,16,47,0.34,112,206,0.54,0.54,73,118,0.47,50,93,143,24,11,10,66,104,345,0.57,17.79
Raul Lopez,94,1879,206,500,103,271,0.38,103,229,0.45,0.52,142,160,0.88,36,143,179,258,99,0,141,190,657,0.58,19.82
Raul Mena,2,12,2,4,1,2,0.5,1,2,0.5,0.62,1,4,0.25,0,2,2,0,0,0,1,4,6,0.52,14.79
Raviv Limonad,14,323,52,110,16,35,0.46,36,75,0.48,0.55,27,32,0.84,9,23,32,58,11,0,24,32,147,0.59,16.21
Rawle Marshall,14,383,54,140,21,55,0.38,33,85,0.39,0.46,45,53,0.85,6,46,52,17,17,3,22,23,174,0.53,11.87
Ray McCallum,46,999,169,411,28,98,0.29,141,313,0.45,0.45,61,95,0.65,32,96,128,145,42,9,80,77,427,0.47,15.02
Reece Gaines,4,118,15,35,7,16,0.44,8,19,0.42,0.53,10,13,0.77,1,8,9,8,4,0,6,10,47,0.58,12.84
Reggie Freeman,31,886,112,273,45,137,0.33,67,136,0.49,0.49,72,91,0.79,35,89,124,64,35,7,56,89,341,0.54,15.17
Reggie Redding,46,1165,169,378,35,100,0.35,134,278,0.48,0.49,62,83,0.75,45,130,175,147,35,13,89,94,435,0.52,17.68
Renaldas Seibutis,94,1829,214,517,50,158,0.32,164,359,0.46,0.46,144,172,0.85,47,141,188,129,56,6,124,208,622,0.52,17.3
Reyshawn Terry,29,567,77,188,21,71,0.3,56,117,0.48,0.47,63,75,0.84,32,97,129,19,32,14,46,74,238,0.54,17.23
Ricardo Greer,53,1445,182,412,29,95,0.31,153,317,0.48,0.48,125,181,0.73,92,174,266,149,76,2,137,111,518,0.53,21.79
Riccardo Moraschini,15,257,25,58,9,31,0.29,16,27,0.59,0.51,20,24,0.83,1,38,39,16,10,1,14,22,79,0.58,16.96
Riccardo Pittis,75,1873,193,335,3,16,0.19,190,319,0.6,0.58,89,205,0.43,54,179,233,271,161,13,126,195,478,0.56,22.86
Richard Hendrix,60,1316,235,423,3,10,0.3,232,413,0.56,0.56,100,145,0.66,144,235,379,89,38,66,80,180,573,0.59,14.11
Richard Mandeville,10,181,28,50,0,2,0.0,28,48,0.58,0.56,15,20,0.75,7,26,33,3,4,0,12,31,71,0.6,16.95
Richard Stafford,10,101,8,22,5,14,0.36,3,8,0.38,0.48,8,9,0.89,2,14,16,10,4,0,8,11,29,0.56,23.56
Rick Rickert,14,374,67,160,4,16,0.25,63,144,0.44,0.43,19,29,0.66,32,41,73,6,10,4,24,48,157,0.45,12.2
Rickey Paulding,10,312,37,111,16,61,0.26,21,50,0.42,0.41,20,28,0.71,4,18,22,20,4,2,28,29,110,0.45,18.5
Ricky Hickman,152,3673,496,1217,178,531,0.34,318,686,0.46,0.48,436,553,0.79,59,300,359,390,145,15,267,338,1606,0.55,15.46
Ricky Ledo,13,273,39,127,14,53,0.26,25,74,0.34,0.36,11,18,0.61,10,38,48,21,10,1,19,14,103,0.38,12.34
Ricky Minard,25,648,91,216,21,46,0.46,70,170,0.41,0.47,50,68,0.74,19,79,98,59,40,7,42,67,253,0.51,14.59
Ricky Rubio,63,1284,90,264,34,123,0.28,56,141,0.4,0.41,134,161,0.78,46,132,178,219,124,3,125,137,348,0.52,27.18
Rico Hill,12,289,45,111,13,38,0.34,32,73,0.44,0.46,24,27,0.89,12,37,49,9,13,1,27,28,127,0.52,18.01
Rihards Kuksiks,7,151,21,45,12,27,0.44,9,18,0.5,0.6,5,5,1.0,1,12,13,4,5,1,1,19,59,0.62,2.07
Rihards Lomazs,27,356,41,103,22,57,0.39,19,46,0.41,0.5,28,33,0.85,6,16,22,22,9,0,16,54,132,0.56,11.98
Rimantas Kaukenas,114,2768,477,1019,84,249,0.34,393,770,0.51,0.51,285,326,0.9,75,147,222,208,118,4,211,254,1323,0.57,15.36
Rinalds Malmanis,11,132,9,22,3,8,0.38,6,14,0.43,0.48,6,8,0.75,6,15,21,7,4,1,2,24,27,0.53,7.27
Robbie Hummel,9,212,26,68,10,27,0.37,16,41,0.39,0.46,6,7,0.86,11,25,36,9,4,0,10,24,68,0.48,12.33
Robert Archibald,19,369,63,103,0,2,0.0,63,101,0.62,0.61,65,95,0.68,53,60,113,13,25,5,32,75,191,0.66,18.1
Robert Conley,16,254,31,87,14,39,0.36,17,48,0.35,0.44,28,39,0.72,5,23,28,16,15,0,24,31,104,0.5,18.73
Robert Fultz,16,186,18,45,10,29,0.34,8,16,0.5,0.51,5,13,0.38,5,6,11,21,5,0,17,26,51,0.5,25.1
Robert Garrett,34,741,84,193,39,100,0.39,45,93,0.48,0.54,62,86,0.72,13,66,79,45,20,1,57,63,269,0.58,19.8
Robert Gulyas,32,774,162,278,5,11,0.45,157,267,0.59,0.59,74,96,0.73,53,104,157,24,9,33,37,97,403,0.63,10.36
Robert Hite,2,17,1,3,1,2,0.5,0,1,0.0,0.5,3,4,0.75,1,1,2,1,1,0,1,3,6,0.63,17.36
Robert Maras,12,253,32,59,0,1,0.0,32,58,0.55,0.54,10,15,0.67,26,38,64,3,9,5,17,33,74,0.56,20.58
Robert Pack,21,612,111,234,13,38,0.34,98,196,0.5,0.5,99,122,0.82,7,39,46,66,30,2,72,55,334,0.58,20.02
Robert Rothbart,9,160,30,60,1,2,0.5,29,58,0.5,0.51,12,15,0.8,16,32,48,3,2,6,14,16,73,0.55,17.37
Robert Skibniewski,9,117,5,20,2,11,0.18,3,9,0.33,0.3,5,8,0.62,0,5,5,16,6,0,3,12,17,0.36,11.31
Robert Troha,21,240,19,49,10,31,0.32,9,18,0.5,0.49,2,3,0.5,4,14,18,5,10,1,7,15,50,0.5,12.21
Robert Wintermantel,5,14,2,2,1,1,1.0,1,1,1.0,1.25,2,2,1.0,0,2,2,0,0,0,1,3,7,1.22,25.77
Robert Witka,9,90,5,21,4,15,0.27,1,6,0.17,0.33,2,2,1.0,4,7,11,2,1,0,4,9,16,0.37,15.46
Robertas Javtokas,136,3256,441,804,6,31,0.19,435,773,0.56,0.55,168,339,0.54,283,453,736,111,64,135,198,360,1056,0.55,17.2
Roberto Chiacig,20,298,47,89,0,1,0.0,47,88,0.53,0.53,41,59,0.7,31,47,78,6,16,12,14,44,135,0.59,10.86
Roberto Duenas,12,226,43,75,0,1,0.0,43,74,0.58,0.57,3,16,0.19,31,31,62,6,9,9,20,29,89,0.54,19.6
Roberto Gabini,55,781,88,226,47,136,0.35,41,90,0.46,0.49,15,21,0.73,25,96,121,19,45,9,59,143,238,0.51,20.05
Roberto Nunez,7,81,9,19,5,14,0.36,4,5,0.8,0.61,5,9,0.56,2,10,12,4,5,0,7,8,28,0.61,23.36
Roberts Stelmahers,71,1806,195,486,75,226,0.33,120,260,0.46,0.48,178,218,0.81,22,127,149,178,70,0,86,181,643,0.55,12.88
Robin Amaize,15,63,4,11,3,7,0.43,1,4,0.25,0.5,1,2,0.5,1,2,3,4,2,0,3,18,12,0.51,20.16
Robin Benzing,32,561,72,168,27,75,0.36,45,93,0.48,0.51,45,53,0.83,15,48,63,21,20,5,22,80,216,0.56,10.31
Robin Grey,9,220,20,45,7,13,0.54,13,32,0.41,0.52,13,17,0.76,5,17,22,5,7,1,9,36,60,0.57,14.64
Rod Sellers,14,426,77,144,0,2,0.0,77,142,0.54,0.53,54,72,0.75,27,64,91,12,7,5,26,42,208,0.59,12.89
Roderick Blakney,48,1096,110,271,41,108,0.38,69,163,0.42,0.48,62,71,0.87,18,60,78,113,51,3,45,116,323,0.53,12.96
Rodney Buford,21,403,73,160,14,43,0.33,59,117,0.5,0.5,11,12,0.94,6,39,45,24,17,4,19,42,171,0.52,10.31
Rodolfo Rombaldoni,30,409,34,98,9,37,0.24,25,61,0.41,0.39,20,34,0.73,11,25,36,40,23,4,36,54,97,0.43,24.17
Rodrigo De La Fuente,156,3351,329,725,81,235,0.34,248,490,0.51,0.51,160,198,0.8,128,360,488,164,121,19,147,256,899,0.55,15.33
Rodrigue Beaubois,134,2819,544,1183,224,571,0.39,320,612,0.52,0.55,147,166,0.9,32,195,227,256,82,51,168,283,1459,0.58,11.8
Roger Esteller,25,659,106,241,29,82,0.35,77,159,0.48,0.5,69,93,0.79,25,46,71,51,10,3,37,53,310,0.55,11.6
Roger Grimau,170,2593,340,718,74,230,0.32,266,488,0.55,0.53,179,218,0.84,68,295,363,164,125,23,161,391,933,0.57,16.51
Roger Huggins,14,417,60,156,4,12,0.33,56,144,0.39,0.4,59,87,0.68,22,68,90,16,32,9,30,49,183,0.47,13.38
Roger Mason,6,161,26,58,16,35,0.46,10,23,0.43,0.59,5,6,0.83,1,16,17,3,9,1,6,18,73,0.6,9.0
Rok Stipcevic,28,583,64,167,36,96,0.38,28,71,0.39,0.49,22,27,0.9,10,39,49,61,15,0,43,50,186,0.52,19.38
Rokas Giedraitis,25,674,114,243,51,128,0.4,63,115,0.55,0.57,65,77,0.84,29,70,99,36,35,2,28,47,344,0.62,9.18
Rokas Jokubaitis,22,134,19,40,4,11,0.36,15,29,0.52,0.52,11,14,0.78,4,7,11,20,3,1,22,17,53,0.57,32.28
Roko Ukic,154,3604,499,1235,131,427,0.31,368,808,0.46,0.46,189,259,0.77,83,233,316,404,94,16,195,222,1318,0.49,12.63
Rolandas Alijevas,6,47,8,19,1,5,0.2,7,14,0.5,0.45,2,7,0.29,4,1,5,5,4,0,2,2,19,0.43,8.31
Rolands Smits,30,321,40,97,19,46,0.41,21,51,0.41,0.51,13,15,0.83,22,35,57,13,6,4,16,44,112,0.54,13.38
Romain Sato,135,3620,425,980,122,336,0.36,303,644,0.47,0.5,295,374,0.79,195,408,603,143,154,25,140,337,1267,0.55,10.9
Romeo Travis,6,109,16,29,0,1,0.0,16,28,0.57,0.55,3,3,1.0,7,16,23,8,5,3,4,9,35,0.58,11.66
Ron Baker,27,299,22,62,13,35,0.37,9,27,0.33,0.46,12,15,0.8,5,20,25,23,17,2,23,27,69,0.5,25.11
Ron Hale,5,118,13,35,4,16,0.25,9,19,0.47,0.43,3,4,0.75,8,7,15,5,6,3,2,9,33,0.45,5.16
Ronald Ellis,23,672,110,232,33,86,0.38,77,146,0.53,0.55,36,51,0.69,55,102,157,33,27,6,55,71,289,0.57,17.77
Ronald Murray,6,77,9,32,2,13,0.15,7,19,0.37,0.31,5,6,0.83,0,5,5,6,5,0,10,9,25,0.36,22.4
Ronell Taylor,13,285,36,83,8,26,0.31,28,57,0.49,0.48,11,13,0.85,6,22,28,12,13,5,18,20,91,0.51,16.87
Ronnie Baker,19,199,14,33,6,18,0.33,8,15,0.53,0.52,8,14,0.56,2,8,10,16,2,0,10,23,42,0.54,20.34
Ronnie Burrell,55,1334,178,358,20,55,0.36,158,303,0.52,0.53,116,146,0.78,104,189,293,60,36,25,92,139,492,0.58,17.89
Ruben Douglas,23,582,101,213,41,104,0.39,60,109,0.55,0.57,56,78,0.67,23,64,87,20,25,7,41,54,299,0.6,14.22
Ruben Wolkowyski,28,626,96,199,22,58,0.38,74,141,0.52,0.54,52,71,0.75,39,94,133,11,20,11,33,72,266,0.58,12.54
Rudy Fernandez,243,5769,799,1951,450,1223,0.37,349,728,0.48,0.52,465,557,0.82,183,575,758,665,287,46,291,412,2513,0.57,11.7
Rumeal Robinson,10,310,63,152,18,59,0.31,45,93,0.48,0.47,34,43,0.79,6,27,33,33,16,0,40,42,178,0.52,18.96
Ruslan Avleev,37,948,149,267,27,55,0.49,122,212,0.58,0.61,136,167,0.81,68,134,202,47,29,12,71,81,461,0.68,17.25
Ruslan Boidakov,4,42,7,13,0,2,0.0,7,11,0.64,0.54,2,2,1.0,5,1,6,0,2,1,1,2,16,0.58,6.72
Russ Smith,7,65,16,45,2,12,0.17,14,33,0.42,0.38,15,22,0.68,2,6,8,6,2,1,6,10,49,0.45,9.89
Ryan Broekhoff,31,785,86,176,58,123,0.47,28,53,0.53,0.65,33,38,0.87,38,66,104,49,31,4,34,69,263,0.68,15.0
Ryan Randle,13,254,38,60,0,1,0.0,38,59,0.64,0.63,10,13,0.77,23,32,55,6,11,6,11,42,86,0.65,14.34
Ryan Stack,14,224,27,52,1,3,0.33,26,49,0.53,0.53,14,21,0.67,15,36,51,9,6,9,16,33,69,0.56,20.71
Ryan Thompson,10,195,19,51,4,21,0.19,15,30,0.5,0.41,6,9,0.67,7,9,16,9,5,1,12,18,48,0.44,17.92
Ryan Toolson,41,870,133,332,58,157,0.37,75,175,0.43,0.49,53,58,0.92,12,38,50,75,18,1,62,60,377,0.53,14.78
Rytis Vaisvila,10,163,13,39,2,11,0.18,11,28,0.39,0.36,11,15,0.73,4,13,17,12,5,0,9,12,39,0.43,16.48
SaJoseen Hauer,2,18,2,5,0,1,0.0,2,4,0.5,0.4,3,5,0.6,0,0,0,0,1,0,3,1,7,0.49,29.41
Sacha Giffa,47,1011,111,256,37,85,0.44,74,171,0.43,0.51,89,104,0.85,62,117,179,57,29,19,73,120,348,0.58,19.48
Salah Mejri,41,377,55,93,2,5,0.4,53,88,0.6,0.6,24,45,0.67,36,67,103,4,15,37,19,58,136,0.6,14.42
Sam Clancy,13,404,76,149,0,1,0.0,76,148,0.51,0.51,31,55,0.56,38,57,95,21,11,11,23,34,185,0.53,11.72
Sam Hoskin,21,468,84,157,6,17,0.35,78,140,0.56,0.55,55,60,0.92,37,77,114,17,12,5,37,50,229,0.62,16.79
Sam Van Rossom,43,959,113,256,57,148,0.39,56,108,0.52,0.55,43,51,0.79,19,69,88,185,19,0,70,78,326,0.59,20.09
Samardo Samuels,74,1501,253,485,11,44,0.25,242,441,0.55,0.53,174,254,0.68,122,173,295,34,25,29,106,153,691,0.58,15.08
Sammy Mejia,16,388,70,147,14,39,0.36,56,108,0.52,0.52,27,34,0.89,25,39,64,33,15,1,32,26,181,0.56,16.5
Samo Grum,14,300,38,86,9,29,0.31,29,57,0.51,0.49,16,21,0.76,0,17,17,12,10,0,11,62,101,0.53,10.35
Samo Udrih,12,226,17,47,8,25,0.32,9,22,0.41,0.45,9,12,0.75,3,13,16,21,4,0,19,28,51,0.49,26.66
Sandi Cebular,12,118,11,31,4,16,0.25,7,15,0.47,0.42,7,13,0.54,5,3,8,5,7,0,7,32,33,0.45,16.01
Sandis Buskevics,13,143,13,38,6,20,0.3,7,18,0.39,0.42,7,8,0.88,2,19,21,12,7,1,12,16,39,0.47,22.42
Sandro Nicevic,37,863,156,302,1,5,0.2,155,297,0.52,0.52,86,102,0.85,42,141,183,60,24,36,74,102,399,0.58,17.58
Sandy Cohen,11,49,5,12,0,3,0.0,5,9,0.56,0.42,3,4,0.75,0,5,5,3,0,1,2,9,13,0.47,12.69
Sani Becirovic,110,2569,373,906,116,326,0.36,257,580,0.44,0.48,433,512,0.86,58,225,283,287,107,9,246,270,1295,0.57,17.86
Santiago Yusta,22,154,22,46,6,18,0.33,16,28,0.57,0.54,10,15,0.67,8,12,20,16,3,1,10,25,60,0.57,15.97
Sarunas Jasikevicius,220,4845,726,1603,309,784,0.39,417,819,0.51,0.55,538,583,0.89,66,281,347,729,135,10,494,469,2299,0.62,20.99
Sarunas Vasiliauskas,5,39,4,10,2,2,1.0,2,8,0.25,0.5,6,8,0.75,2,4,6,4,2,0,1,7,16,0.59,6.89
Sasa Doncic,13,179,13,32,2,15,0.13,11,17,0.65,0.44,9,17,0.53,7,28,35,11,2,1,7,28,37,0.47,15.06
Sasa Obradovic,8,213,19,61,8,41,0.2,11,20,0.55,0.38,15,22,0.68,2,11,13,8,12,1,12,23,61,0.43,14.51
Sasha Pavlovic,45,869,134,320,29,103,0.28,105,217,0.48,0.46,49,74,0.7,27,78,105,53,33,13,47,112,346,0.49,11.76
Sasha Vujacic,48,1118,156,409,66,189,0.35,90,220,0.41,0.46,102,127,0.76,30,110,140,56,38,7,54,105,480,0.52,10.41
Saso Ozbolt,84,1986,195,489,87,252,0.35,108,237,0.46,0.49,140,176,0.8,36,121,157,131,96,9,129,194,617,0.54,18.55
Sasu Salin,58,981,91,278,55,193,0.28,36,85,0.42,0.43,25,32,0.85,24,77,101,60,38,3,48,103,262,0.45,14.11
Saul Blanco,29,493,58,143,21,55,0.38,37,88,0.42,0.48,33,36,0.93,23,34,57,19,17,3,22,30,170,0.54,12.17
Saulius Kazevicius,1,16,2,5,0,2,0.0,2,3,0.67,0.4,0,3,0.0,0,0,0,0,0,0,3,1,4,0.32,32.19
Saulius Kuzminskas,11,160,15,35,1,2,0.5,14,33,0.42,0.44,9,17,0.53,15,27,42,2,7,1,7,44,40,0.47,14.15
Saulius Stombergas,78,2229,309,658,136,324,0.42,173,334,0.52,0.57,160,194,0.83,68,178,246,80,91,10,126,258,914,0.61,14.49
Savvas Iliadis,32,449,61,122,13,28,0.46,48,94,0.51,0.55,44,60,0.77,19,37,56,24,20,0,26,33,179,0.6,14.91
Scoonie Penn,103,3153,393,949,122,359,0.34,271,590,0.46,0.48,293,362,0.82,42,227,269,296,179,1,196,256,1201,0.54,15.03
Scottie Wilbekin,106,2604,442,1072,259,678,0.38,183,394,0.46,0.53,212,260,0.81,38,152,190,324,122,3,193,208,1355,0.57,13.99
Scotty Hopson,11,314,65,104,15,31,0.48,50,73,0.68,0.7,25,34,0.74,11,35,46,12,14,5,25,25,170,0.71,17.37
Sean Colson,5,154,25,66,10,32,0.31,15,34,0.44,0.45,12,16,0.75,4,8,12,16,3,0,8,13,72,0.49,9.87
Sean Kilpatrick,15,317,54,125,16,48,0.33,38,77,0.49,0.5,14,15,0.93,3,22,25,16,13,2,11,25,138,0.52,7.71
Sean May,17,360,53,120,7,24,0.29,46,96,0.48,0.47,26,37,0.71,25,55,80,14,9,5,22,39,139,0.51,13.9
Sean Singletary,16,210,21,55,4,14,0.29,17,41,0.41,0.42,9,19,0.47,8,19,27,23,13,0,19,27,55,0.43,23.07
Semaj Christon,7,177,25,56,6,21,0.29,19,35,0.54,0.5,8,11,0.73,2,6,8,26,2,0,8,17,64,0.53,11.62
Semen Antonov,128,1642,163,387,70,190,0.37,93,197,0.47,0.51,48,67,0.75,81,150,231,72,40,47,61,243,444,0.53,12.78
Semih Erden,40,611,69,142,1,4,0.25,68,138,0.49,0.49,46,96,0.5,46,82,128,17,13,18,46,96,185,0.5,19.98
Sergei Chikalkin,21,519,82,169,33,74,0.45,49,95,0.52,0.58,44,48,0.92,7,20,27,18,15,0,22,28,241,0.63,10.37
Sergei Lishouk,21,340,47,106,1,3,0.33,46,103,0.45,0.45,37,69,0.54,45,57,102,9,6,18,17,67,132,0.48,11.09
Sergei Monia,200,3330,363,870,204,532,0.38,159,338,0.47,0.53,90,113,0.8,136,390,526,189,116,117,169,416,1020,0.55,15.52
Sergey Bazarevitch,10,279,35,86,5,27,0.19,30,59,0.51,0.44,37,44,0.84,3,14,17,28,7,0,45,25,112,0.53,29.93
Sergey Bykov,71,905,86,211,18,67,0.27,68,144,0.47,0.45,45,76,0.63,19,66,85,94,47,5,78,144,235,0.48,24.19
Sergey Gladyr,5,131,13,39,6,24,0.25,7,15,0.47,0.41,0,1,0.0,3,12,15,6,6,2,12,8,32,0.41,23.33
Sergey Karasev,22,271,29,67,16,40,0.4,13,27,0.48,0.55,9,9,1.0,13,19,32,17,8,2,12,41,83,0.58,14.46
Sergey Panov,105,1576,186,371,53,145,0.37,133,226,0.59,0.57,102,126,0.82,100,237,337,107,100,21,89,273,527,0.62,17.27
Sergi Garcia,8,104,13,30,6,16,0.38,7,14,0.5,0.53,3,3,1.0,5,4,9,12,2,0,8,13,35,0.56,20.35
Sergi Vidal,226,4075,341,792,117,333,0.35,224,459,0.49,0.5,271,361,0.71,107,378,485,309,190,11,191,292,1070,0.56,16.73
Sergio Llull,283,6852,992,2414,451,1320,0.34,541,1094,0.49,0.5,536,651,0.8,86,385,471,1082,183,23,389,560,2971,0.55,12.59
Sergio Rodriguez,262,5796,965,2167,435,1083,0.4,530,1084,0.49,0.55,426,497,0.85,80,406,486,1242,221,15,532,511,2791,0.58,18.23
Sergiy Gorbenko,10,60,2,12,1,11,0.09,1,1,1.0,0.21,2,2,1.0,2,5,7,2,0,0,1,9,7,0.27,7.2
Serhat Cetin,35,619,63,155,31,98,0.32,32,57,0.56,0.51,15,21,0.82,4,38,42,41,5,2,42,60,172,0.52,20.36
Serkan Erdogan,109,2389,373,870,179,457,0.39,194,413,0.47,0.53,201,261,0.8,34,137,171,138,72,3,127,209,1126,0.57,11.42
Sertac Sanli,30,277,66,100,2,8,0.25,64,92,0.7,0.67,30,38,0.79,20,30,50,7,4,9,18,50,164,0.7,13.36
Shalom Turgeman,10,248,31,71,14,28,0.5,17,43,0.4,0.54,8,9,0.89,13,18,31,18,15,1,27,22,84,0.56,26.48
Shammond Williams,31,770,117,244,52,131,0.4,65,113,0.58,0.59,53,66,0.81,10,59,69,119,30,0,76,67,339,0.62,21.77
Shane Larkin,93,2472,446,939,203,463,0.44,243,476,0.51,0.58,330,385,0.86,42,202,244,399,105,12,210,168,1425,0.64,15.93
Shaquielle McKissic,3,78,18,34,3,11,0.27,15,23,0.65,0.57,2,5,0.4,0,6,6,5,3,2,7,8,41,0.57,16.2
Sharon Shason,44,398,46,113,25,72,0.35,21,41,0.51,0.52,27,32,0.83,20,44,64,15,13,6,15,95,144,0.57,10.56
Sharrod Ford,30,600,98,219,17,68,0.25,81,151,0.54,0.49,32,49,0.66,48,103,151,14,9,26,52,81,245,0.51,17.77
Shaun Stonerook,113,2806,182,453,100,294,0.34,82,159,0.52,0.51,108,154,0.71,85,466,551,191,201,35,161,422,572,0.55,23.62
Shaun Vandiver,11,298,45,101,4,19,0.21,41,82,0.5,0.47,10,13,0.77,24,34,58,9,8,4,20,32,104,0.49,15.78
Shavon Shields,59,1466,216,453,54,154,0.35,162,299,0.54,0.54,83,95,0.87,57,124,181,62,29,7,59,107,569,0.57,10.65
Shawn James,60,1090,203,329,1,8,0.12,202,321,0.63,0.62,79,119,0.7,109,164,273,48,39,82,57,143,486,0.64,13.0
Shawnta Rogers,7,217,28,80,11,34,0.32,17,46,0.37,0.42,9,12,0.75,5,16,21,28,12,0,8,20,76,0.45,8.58
Shelden Williams,10,230,44,85,0,1,0.0,44,84,0.52,0.52,25,39,0.64,31,45,76,11,11,7,23,33,113,0.55,18.38
Shelvin Mack,11,190,22,60,4,12,0.33,18,48,0.38,0.4,6,8,0.75,4,16,20,20,5,0,18,17,54,0.43,22.08
Sherman Hamilton,5,46,5,13,3,7,0.43,2,6,0.33,0.5,3,6,0.5,0,3,3,2,3,0,5,2,16,0.51,24.22
Siim Sander Vene,63,776,99,210,35,98,0.36,64,112,0.57,0.55,30,38,0.78,34,61,95,35,25,5,22,101,263,0.58,8.85
Silas Cheung,14,344,23,65,12,43,0.28,11,22,0.5,0.45,7,10,0.7,14,23,37,13,11,0,17,26,65,0.47,19.68
Silvio Gigena,33,426,56,132,18,65,0.28,38,67,0.57,0.49,27,35,0.8,38,39,77,9,27,2,23,49,157,0.53,13.5
Simas Jasaitis,103,2283,290,617,138,356,0.39,152,261,0.58,0.58,88,108,0.84,116,199,315,68,74,11,69,212,806,0.61,9.41
Simon Petrov,50,849,112,250,49,126,0.39,63,124,0.51,0.55,88,96,0.92,8,34,42,68,13,1,38,107,361,0.62,11.51
Simonas Serapinas,53,763,92,207,46,118,0.39,46,89,0.52,0.56,30,46,0.62,19,68,87,28,34,2,39,80,260,0.57,14.65
Simone Cotani,5,31,1,4,0,1,0.0,1,3,0.33,0.25,0,2,0.0,1,0,1,2,3,0,4,6,2,0.2,45.05
Simone Flamini,13,147,9,27,4,11,0.36,5,16,0.31,0.41,10,14,0.71,7,9,16,2,11,0,5,13,32,0.48,13.1
Sinan Guler,175,2749,336,808,90,326,0.28,246,482,0.51,0.47,74,104,0.72,63,234,297,326,127,30,200,311,836,0.49,18.98
Sinisa Kovacevic,10,125,14,28,0,8,0.0,14,20,0.7,0.5,14,20,0.7,3,4,7,13,3,0,8,24,42,0.57,17.86
Slaven Rimac,49,1170,189,415,63,145,0.43,126,270,0.47,0.53,94,115,0.85,23,86,109,73,27,7,88,102,535,0.57,15.9
Slavko Duscak,14,399,57,132,22,57,0.39,35,75,0.47,0.52,26,36,0.72,6,16,22,30,11,0,36,31,162,0.55,19.58
Slobodan Bozovic,10,162,19,48,8,26,0.31,11,22,0.5,0.48,6,8,0.75,11,16,27,2,7,1,6,32,52,0.5,10.43
Slobodan Savovic,3,27,1,5,0,3,0.0,1,2,0.5,0.2,3,4,0.75,0,4,4,1,1,0,2,4,5,0.37,22.83
Smiljan Pavic,26,313,37,96,6,14,0.43,31,82,0.38,0.42,21,33,0.8,29,31,60,6,11,12,16,49,101,0.46,12.65
Sofoklis Schortsanitis,13,109,21,37,0,1,0.0,21,36,0.58,0.57,15,24,0.62,7,16,23,4,3,1,20,23,57,0.6,29.6
Soner Senturk,5,56,4,9,2,4,0.5,2,5,0.4,0.56,0,4,0.0,0,5,5,12,3,0,5,7,10,0.46,31.73
Sonny Weems,123,3475,620,1352,158,438,0.36,462,914,0.51,0.52,226,298,0.75,67,377,444,364,107,19,271,277,1624,0.55,15.45
Sotiris Nikolaidis,29,282,16,56,6,28,0.21,10,28,0.36,0.34,26,34,0.76,3,21,24,27,21,0,30,69,64,0.45,29.71
Souarata Cisse,21,215,22,54,8,25,0.32,14,29,0.48,0.48,12,21,0.57,6,8,14,6,14,1,17,30,64,0.51,21.19
Spencer Dunkley,9,143,14,35,0,2,0.0,14,33,0.42,0.4,12,17,0.71,12,27,39,2,11,5,8,16,40,0.47,15.85
Spencer Nelson,43,1058,144,340,30,102,0.29,114,238,0.48,0.47,92,122,0.84,104,197,301,77,38,10,88,125,410,0.52,18.27
Spiros Panteliadis,59,729,65,140,15,48,0.31,50,92,0.54,0.52,78,107,0.7,15,55,70,84,46,1,67,83,223,0.6,26.37
Srdan Subotic,8,142,9,22,4,6,0.67,5,16,0.31,0.5,5,6,0.83,3,12,15,11,2,0,7,15,27,0.55,22.12
Stanislav Ilnitskiy,8,74,2,7,1,6,0.17,1,1,1.0,0.36,2,2,1.0,4,10,14,2,3,0,3,13,7,0.44,27.57
Stanko Barac,92,1546,258,478,7,20,0.35,251,458,0.55,0.55,137,201,0.7,126,252,378,56,27,66,116,223,660,0.58,17.0
Stanley Jackson,13,211,23,57,3,20,0.15,20,37,0.54,0.43,8,9,0.89,5,20,25,18,10,3,16,23,57,0.47,20.79
Stanton Kidd,30,653,77,197,27,95,0.28,50,102,0.49,0.46,24,35,0.69,18,73,91,36,18,7,29,63,205,0.48,12.01
Steed Tchicamboud,24,586,59,158,19,65,0.29,40,93,0.43,0.43,61,78,0.84,14,49,63,66,17,0,61,59,198,0.51,24.08
Stefan Jankovic,28,332,42,108,7,37,0.19,35,71,0.49,0.42,16,19,0.84,28,42,70,13,10,12,13,57,107,0.46,10.05
Stefan Jovic,115,2460,302,657,86,229,0.38,216,428,0.5,0.53,91,133,0.68,50,219,269,538,139,7,208,268,781,0.55,22.52
Stefan Markovic,91,2045,143,415,72,247,0.29,71,168,0.42,0.43,92,119,0.77,43,164,207,368,82,4,137,210,450,0.48,22.67
Stefan Peno,10,48,3,8,1,3,0.33,2,5,0.4,0.44,4,4,1.0,2,4,6,5,3,1,6,10,11,0.56,38.07
Stefan Sinovec,9,22,4,6,0,1,0.0,4,5,0.8,0.67,4,6,0.67,2,1,3,1,0,1,4,2,12,0.69,31.65
Stefano Attruia,12,245,29,54,12,32,0.38,17,22,0.77,0.65,16,18,0.89,1,12,13,27,12,0,13,27,86,0.69,17.35
Stefano Garris,36,770,71,205,28,99,0.28,43,106,0.41,0.41,26,39,0.62,27,70,97,20,27,1,36,101,196,0.44,13.94
Stefano Gentile,3,15,4,6,1,3,0.33,3,3,1.0,0.75,3,4,0.75,0,1,1,0,1,0,1,5,12,0.77,11.42
Stefano Mancinelli,116,2252,295,608,60,204,0.29,235,404,0.58,0.53,97,146,0.68,99,232,331,137,116,24,107,259,747,0.56,13.73
Steffen Hamann,58,1011,98,228,24,79,0.3,74,149,0.5,0.48,71,94,0.73,10,80,90,102,41,4,81,124,291,0.54,23.12
Stephane Lasme,113,2295,310,613,4,16,0.25,306,597,0.51,0.51,238,331,0.7,177,326,503,81,86,122,175,363,862,0.57,18.74
Stephane Pelle,14,347,49,129,0,1,0.0,49,128,0.38,0.38,18,28,0.64,38,64,102,11,8,4,28,34,116,0.41,16.54
Stephane Risacher,96,2101,317,633,98,243,0.4,219,390,0.56,0.58,168,214,0.78,64,209,273,86,56,28,123,191,900,0.62,14.47
Stephen Barnes,4,36,2,11,0,1,0.0,2,10,0.2,0.18,2,2,1.0,1,4,5,0,1,0,3,4,6,0.25,20.16
Stephen Tison,5,14,1,3,0,2,0.0,1,1,1.0,0.33,4,4,1.0,0,1,1,2,0,0,1,4,6,0.63,17.36
Steponas Babrauskas,44,762,65,181,41,110,0.37,24,71,0.34,0.47,32,45,0.66,30,61,91,20,26,2,39,115,203,0.51,16.26
Stevan Jelovac,10,136,24,58,5,26,0.19,19,32,0.59,0.46,8,13,0.62,4,19,23,3,6,1,12,18,61,0.48,15.85
Stevan Nadjfeji,18,252,28,60,15,30,0.5,13,30,0.43,0.59,17,19,0.94,18,17,35,13,6,0,16,39,88,0.64,18.97
Steve Bucknall,9,322,42,105,16,43,0.37,26,62,0.42,0.48,42,52,0.81,9,16,25,19,11,1,18,25,142,0.56,12.34
Steve Woodberry,27,860,124,265,21,54,0.39,103,211,0.49,0.51,54,76,0.65,36,86,122,79,39,6,57,41,323,0.54,16.04
Steven Edwards,5,147,18,50,10,33,0.3,8,17,0.47,0.46,21,25,0.84,6,13,19,19,7,0,16,9,67,0.55,20.78
Steven Hansell,12,138,15,34,3,10,0.3,12,24,0.5,0.49,11,13,0.85,3,6,9,10,9,1,6,10,44,0.55,13.12
Steven Smith,20,298,50,112,20,46,0.43,30,66,0.45,0.54,25,31,0.81,10,47,57,11,8,1,17,36,145,0.58,11.92
Stevin Smith,20,558,61,147,23,71,0.32,38,76,0.5,0.49,64,75,0.85,6,31,37,75,26,0,40,67,209,0.58,18.18
Stipe Modric,40,570,44,89,8,22,0.36,36,67,0.54,0.54,18,29,0.63,46,69,115,19,39,10,32,122,114,0.56,23.92
Stipo Papic,8,47,8,14,1,1,1.0,7,13,0.54,0.61,2,4,0.5,3,8,11,1,3,1,4,15,19,0.6,20.24
Stjepan Stazic,9,173,29,49,5,14,0.36,24,35,0.69,0.64,13,21,0.62,6,14,20,14,14,0,16,21,76,0.65,21.55
Strahinja Milosevic,55,311,27,58,2,10,0.2,25,48,0.52,0.48,15,27,0.4,25,31,56,12,10,3,17,67,71,0.51,19.57
Stratos Perperoglou,222,4275,564,1351,206,555,0.37,358,796,0.45,0.49,249,327,0.7,95,488,583,234,160,40,207,435,1583,0.53,12.16
Stuart Robbins,14,204,28,75,0,2,0.0,28,73,0.38,0.37,11,23,0.48,17,22,39,4,3,3,20,24,67,0.39,19.03
Suad Sehovic,22,312,27,59,23,55,0.42,4,4,1.0,0.65,5,5,1.0,7,34,41,10,8,2,2,47,82,0.67,3.16
Sven Schultze,45,425,54,130,24,65,0.37,30,65,0.46,0.51,12,22,0.56,21,32,53,18,10,1,31,102,144,0.52,18.16
Sylven Landesberg,95,1332,211,473,69,191,0.36,142,282,0.5,0.52,75,110,0.71,34,119,153,44,24,4,52,125,566,0.54,9.07
Szymon Szewczyk,36,509,81,167,19,62,0.31,62,105,0.59,0.54,36,52,0.68,31,67,98,12,22,12,34,88,217,0.57,15.19
T.J. Bray,10,204,22,55,12,32,0.38,10,23,0.43,0.51,8,9,0.89,3,14,17,27,9,0,16,22,64,0.54,21.34
TJ Ford,2,33,3,10,1,3,0.33,2,7,0.29,0.35,5,6,0.83,1,4,5,13,3,0,6,5,12,0.47,32.19
TJ Lux,14,259,50,103,0,2,0.0,50,101,0.5,0.49,30,38,0.79,34,23,57,11,22,2,15,47,130,0.54,11.13
Tadas Klimavicius,78,1288,128,323,23,97,0.24,105,226,0.46,0.43,55,91,0.54,105,164,269,57,19,38,81,110,334,0.46,18.24
Tadas Sedekerskis,13,65,6,10,0,1,0.0,6,9,0.67,0.6,5,8,0.62,3,5,8,2,1,0,4,4,17,0.63,22.83
Tadija Dragicevic,10,154,20,47,10,27,0.37,10,20,0.5,0.53,12,14,0.86,2,17,19,6,4,2,10,10,62,0.58,15.83
Tal Burstein,176,3623,404,908,110,322,0.34,294,586,0.5,0.51,210,279,0.76,81,375,456,306,139,17,203,427,1128,0.55,16.45
Tamar Slay,10,274,36,106,9,38,0.24,27,68,0.4,0.38,11,13,0.85,7,37,44,10,13,4,21,36,92,0.41,15.82
Tanel Tein,14,419,38,92,17,54,0.31,21,38,0.55,0.51,21,24,0.88,12,29,41,11,17,2,8,39,114,0.56,7.24
Tanoka Beard,73,2122,426,795,12,64,0.19,414,731,0.57,0.54,243,333,0.71,247,416,663,97,83,38,181,232,1107,0.59,16.12
Taqwa Pinero,17,419,64,168,29,99,0.29,35,69,0.51,0.47,24,28,0.81,7,39,46,16,17,0,23,43,181,0.5,11.31
Tarence Kinsey,94,2455,373,868,58,197,0.29,315,671,0.47,0.46,218,281,0.75,73,259,332,134,136,19,143,208,1022,0.52,12.6
Tarik Biberovic,8,47,7,20,1,8,0.12,6,12,0.5,0.38,3,6,0.5,2,10,12,1,1,0,3,2,18,0.4,11.7
Tarik Black,26,559,116,167,0,1,0.0,116,166,0.7,0.69,54,79,0.68,56,85,141,18,12,20,37,75,286,0.71,15.5
Taylor Coppenrath,13,372,48,97,3,8,0.38,45,89,0.51,0.51,45,57,0.79,24,23,47,6,13,5,14,32,144,0.59,10.29
Taylor Rochestie,96,2204,396,841,146,337,0.43,250,504,0.5,0.56,170,190,0.8,37,122,159,419,54,2,170,193,1108,0.6,15.53
Teddy Gipson,16,330,45,112,20,44,0.45,25,68,0.37,0.49,12,19,0.63,4,18,22,33,6,1,24,41,122,0.51,16.63
Teemu Rannikko,55,1352,130,335,82,238,0.34,48,97,0.49,0.51,133,159,0.86,14,65,79,129,55,1,73,138,475,0.59,15.27
Teo Cizmic,14,211,28,62,17,36,0.47,11,26,0.42,0.59,12,16,0.75,4,19,23,8,5,0,11,19,85,0.62,13.74
Teoman Ozturk,38,533,64,141,8,30,0.27,56,111,0.5,0.48,39,56,0.71,25,54,79,8,20,10,27,69,175,0.53,14.02
Terence Morris,87,1996,286,530,96,222,0.43,190,308,0.62,0.63,62,88,0.69,118,352,470,89,58,98,92,149,730,0.64,13.92
Terrel Castle,31,856,72,182,34,92,0.37,38,90,0.42,0.49,79,107,0.73,17,58,75,58,42,2,81,66,257,0.56,26.12
Terrell Lyday,51,1237,182,437,62,170,0.36,120,267,0.45,0.49,141,187,0.76,26,92,118,112,75,9,100,133,567,0.55,16.15
Terrell McIntyre,69,1947,298,687,171,444,0.39,127,243,0.52,0.56,150,166,0.91,34,101,135,312,128,0,160,140,917,0.6,17.39
Terrell Myers,13,400,82,188,25,76,0.33,57,112,0.51,0.5,21,28,0.75,9,28,37,17,10,0,36,40,210,0.52,15.23
Thabo Sefolosha,7,188,27,51,7,14,0.5,20,37,0.54,0.6,19,30,0.63,6,36,42,6,15,3,12,21,80,0.62,15.75
Thanasis Antetokounmpo,62,723,98,175,11,36,0.31,87,139,0.63,0.59,34,65,0.52,45,78,123,21,32,19,28,131,241,0.59,12.09
Thanassis Efthimiou,8,75,7,19,1,7,0.14,6,12,0.5,0.39,5,8,0.62,4,7,11,7,2,2,6,10,20,0.44,21.04
Theo Maledon,22,389,57,125,18,49,0.37,39,76,0.51,0.53,31,45,0.69,4,35,39,69,7,2,41,64,163,0.56,22.07
Theodore Allen,4,106,13,34,0,8,0.0,13,26,0.5,0.38,7,11,0.64,12,13,25,3,10,1,13,17,33,0.42,25.08
Theodoros Papaloukas,252,5089,618,1175,100,333,0.3,518,842,0.62,0.57,388,559,0.69,106,493,599,977,335,23,433,514,1724,0.61,23.36
Thierry Gadou,22,316,31,81,11,37,0.3,20,44,0.45,0.45,22,31,0.71,13,28,41,19,12,3,25,35,95,0.5,20.9
Thomas Adams,10,311,40,89,13,30,0.43,27,59,0.46,0.52,25,30,0.83,16,31,47,16,10,1,32,28,118,0.58,23.85
Thomas Heurtel,214,5008,806,1715,231,600,0.38,575,1115,0.52,0.54,318,398,0.78,74,384,458,1187,149,1,511,355,2161,0.57,21.28
Thomas Kelati,28,585,82,192,50,128,0.39,32,64,0.5,0.56,26,36,0.55,9,48,57,35,29,6,33,58,240,0.58,13.7
Thomas Robinson,20,312,69,142,0,1,0.0,69,141,0.49,0.49,25,60,0.42,49,68,117,8,13,11,21,52,163,0.48,11.09
Thomas Van de vondel,11,113,6,14,0,4,0.0,6,10,0.6,0.43,0,1,0.0,3,7,10,4,1,0,7,21,12,0.42,32.65
Thomas Walkup,62,1293,172,350,41,104,0.39,131,246,0.53,0.55,61,73,0.83,44,146,190,229,46,4,115,166,446,0.58,23.13
Tiago Splitter,58,1410,298,493,0,5,0.0,298,488,0.61,0.6,201,319,0.63,85,218,303,84,48,56,100,178,797,0.63,13.64
Tibor Pleiss,192,3148,603,1043,27,76,0.36,576,967,0.6,0.59,231,283,0.82,280,571,851,79,55,152,177,392,1464,0.63,13.16
Tierre Brown,6,168,31,82,2,20,0.1,29,62,0.47,0.39,22,27,0.82,6,11,17,17,12,1,15,12,86,0.46,13.78
Tim Abromaitis,37,677,101,208,39,100,0.39,62,108,0.57,0.58,36,49,0.68,41,92,133,34,18,10,22,72,277,0.6,8.75
Tim Begley,20,288,36,79,21,51,0.41,15,28,0.54,0.59,9,14,0.64,5,17,22,10,8,1,17,34,102,0.6,16.64
Tim Kennedy,10,287,33,73,11,33,0.33,22,40,0.55,0.53,8,11,0.73,5,17,22,10,6,1,17,19,85,0.55,17.92
Tim Ohlbrecht,11,179,13,30,0,2,0.0,13,28,0.46,0.43,10,14,0.71,7,21,28,0,3,7,10,28,36,0.5,21.66
Tim Schneider,16,190,20,51,14,38,0.37,6,13,0.46,0.53,6,8,0.75,7,13,20,5,5,2,8,25,60,0.55,12.8
Toby Bailey,20,628,79,201,35,99,0.35,44,102,0.43,0.48,48,65,0.74,25,59,84,27,21,10,34,60,241,0.52,12.9
Tom Wideman,10,212,25,56,0,1,0.0,25,55,0.45,0.45,22,32,0.69,26,39,65,9,12,2,11,29,72,0.51,13.57
Tomas Delininkaitis,51,762,95,250,54,149,0.36,41,101,0.41,0.49,78,102,0.75,16,47,63,66,25,0,62,90,322,0.55,17.37
Tomas Dimsa,25,297,26,72,9,25,0.36,17,47,0.36,0.42,8,13,0.36,15,18,33,16,5,2,11,43,69,0.44,12.4
Tomas Masiulis,81,1884,198,381,28,90,0.31,170,291,0.58,0.56,71,150,0.51,144,262,406,117,85,41,120,195,495,0.55,21.16
Tomas Pacesas,32,945,60,181,37,129,0.29,23,52,0.44,0.43,16,30,0.56,26,61,87,114,50,2,62,79,173,0.45,24.2
Tomas Ress,156,2015,222,470,79,197,0.4,143,273,0.52,0.56,93,127,0.69,90,256,346,52,65,72,72,225,616,0.59,12.04
Tomas Satoransky,56,1229,161,332,44,117,0.38,117,215,0.54,0.55,91,113,0.8,36,126,162,210,49,14,72,111,457,0.6,15.87
Tomasz Swietonski,2,20,1,7,1,4,0.25,0,3,0.0,0.21,2,2,1.0,0,1,1,2,0,0,2,5,5,0.32,20.24
Tomislav Knezevic,4,29,2,4,1,1,1.0,1,3,0.33,0.62,2,2,1.0,0,0,0,4,0,0,0,4,7,0.72,0.0
Tomislav Ruzic,46,901,144,262,14,33,0.42,130,229,0.57,0.58,48,63,0.76,65,114,179,20,25,14,36,116,350,0.6,11.05
Tomislav Zubcic,39,606,70,188,28,86,0.33,42,102,0.41,0.45,39,52,0.68,33,86,119,24,21,3,36,56,207,0.49,14.58
Tommy Thorwarth,7,82,5,13,2,8,0.25,3,5,0.6,0.46,5,6,0.83,6,4,10,3,4,0,4,18,17,0.54,20.37
Toney Douglas,34,803,139,337,52,148,0.35,87,189,0.46,0.49,70,80,0.87,27,68,95,108,42,3,65,91,400,0.54,14.87
Toni Brnas,6,68,2,13,1,4,0.25,1,9,0.11,0.19,1,1,1.0,1,5,6,0,3,1,3,9,6,0.22,18.25
Toni Dijan,19,284,44,71,2,6,0.33,42,65,0.65,0.63,18,26,0.79,16,27,43,19,8,2,14,33,108,0.66,14.52
Toni Katic,7,80,6,13,1,4,0.25,5,9,0.56,0.5,11,13,0.85,1,7,8,13,1,0,7,9,24,0.64,27.22
Tonin Llorente,9,68,4,7,2,5,0.4,2,2,1.0,0.71,1,2,0.5,0,9,9,8,1,0,5,11,11,0.7,38.82
Tony Crocker,30,688,91,239,44,136,0.32,47,103,0.46,0.47,42,45,0.93,19,51,70,41,24,2,39,88,268,0.52,13.1
Tony Delk,17,279,44,108,11,35,0.31,33,73,0.45,0.46,29,38,0.76,11,22,33,17,10,1,27,28,128,0.51,17.8
Tony Dorsey,7,234,48,95,3,13,0.23,45,82,0.55,0.52,19,30,0.63,15,20,35,12,8,1,18,15,118,0.55,14.26
Tony Taylor,10,296,31,74,6,19,0.32,25,55,0.45,0.46,37,44,0.84,1,26,27,38,6,0,16,22,105,0.56,14.63
Tonye Jekiri,27,645,92,179,0,3,0.0,92,176,0.52,0.51,51,77,0.66,72,130,202,35,21,8,29,67,235,0.55,11.99
Torey Thomas,4,61,3,18,0,8,0.0,3,10,0.3,0.17,2,2,1.0,0,1,1,9,1,0,4,3,8,0.21,17.48
Tornike Shengelia,147,3560,643,1257,92,248,0.37,551,1009,0.55,0.55,388,551,0.71,216,514,730,259,119,68,276,337,1766,0.59,15.55
Tracy Murray,8,136,25,48,17,36,0.47,8,12,0.67,0.7,5,9,0.56,1,17,18,5,8,6,5,17,72,0.69,8.78
Trajan Langdon,167,5052,752,1546,339,794,0.43,413,752,0.55,0.6,335,386,0.85,82,432,514,210,216,19,228,370,2178,0.63,11.73
Travis Best,13,308,48,110,11,35,0.31,37,75,0.49,0.49,17,20,0.92,4,26,30,35,12,2,28,33,124,0.52,19.07
Travis Hansen,74,1594,230,531,121,289,0.42,109,242,0.45,0.55,96,122,0.83,64,139,203,71,63,13,85,166,677,0.58,12.69
Travis Watson,47,1085,186,322,1,3,0.33,185,319,0.58,0.58,88,150,0.61,162,244,406,58,60,27,89,161,461,0.59,18.66
Tre Kelley,13,330,49,97,17,32,0.53,32,65,0.49,0.59,29,36,0.81,1,16,17,32,12,0,24,37,144,0.64,17.54
Tre Simmons,9,112,14,38,6,17,0.35,8,21,0.38,0.45,5,6,0.83,5,15,20,7,7,0,12,12,39,0.48,22.8
Tremmell Darden,88,1791,221,455,55,135,0.41,166,320,0.52,0.55,75,100,0.75,58,182,240,63,37,41,65,126,572,0.57,11.52
Trent Meacham,10,322,33,91,15,48,0.31,18,43,0.42,0.45,6,6,1.0,3,24,27,41,8,1,12,20,87,0.46,11.36
Trey Thompkins,137,2647,471,975,180,432,0.42,291,543,0.54,0.58,153,177,0.88,108,498,606,119,68,35,127,279,1275,0.61,10.76
Tunji Awojobi,32,744,132,251,4,12,0.33,128,239,0.54,0.53,60,86,0.69,59,103,162,48,44,8,59,62,328,0.57,16.96
Tutku Acik,97,1325,117,280,51,161,0.32,66,119,0.55,0.51,85,115,0.72,9,70,79,144,64,3,88,163,370,0.56,21.02
Txemi Urtasun,31,593,74,193,29,84,0.35,45,109,0.41,0.46,39,52,0.77,10,34,44,39,17,1,40,42,216,0.5,15.63
Ty Lawson,7,149,18,42,3,8,0.38,15,34,0.44,0.46,13,21,0.62,4,17,21,11,6,0,7,13,52,0.51,12.02
Tyler Cavanaugh,19,278,37,100,15,42,0.36,22,58,0.38,0.44,32,33,0.97,17,45,62,18,10,4,9,48,121,0.53,7.29
Tyler Dorsey,28,528,93,240,52,132,0.39,41,108,0.38,0.5,43,63,0.68,14,54,68,41,29,4,43,60,281,0.52,13.84
Tyler Ennis,3,31,7,9,1,1,1.0,6,8,0.75,0.83,4,6,0.67,0,2,2,3,1,0,3,3,19,0.82,20.49
Tyler Honeycutt,75,1671,216,488,73,201,0.36,143,287,0.5,0.52,109,156,0.73,131,357,488,125,78,64,104,132,614,0.55,15.74
Tyrese Rice,112,2697,419,1072,158,465,0.34,261,607,0.43,0.46,255,298,0.85,29,166,195,465,91,9,234,232,1251,0.52,16.28
Tyron McCoy,10,354,49,122,13,47,0.28,36,75,0.48,0.45,42,53,0.79,6,35,41,37,18,1,33,33,153,0.53,18.51
Tyrone Brazelton,9,141,13,46,6,19,0.32,7,27,0.26,0.35,4,5,0.75,4,8,12,12,5,1,12,16,36,0.37,19.93
Tyrone Ellis,17,515,87,185,45,113,0.4,42,72,0.58,0.59,46,65,0.72,17,45,62,45,27,3,47,51,265,0.62,18.04
Tyson Wheeler,13,283,28,82,12,59,0.2,16,23,0.7,0.41,15,17,0.88,3,20,23,49,8,1,19,22,83,0.46,17.51
Tyus Edney,90,2702,485,997,79,202,0.39,406,795,0.51,0.53,321,398,0.81,63,194,257,384,128,5,233,196,1370,0.58,16.58
Uros Slokar,54,725,86,181,17,55,0.31,69,126,0.55,0.52,67,108,0.63,44,96,140,24,33,13,37,86,256,0.56,13.93
Uros Tripkovic,109,2406,324,881,186,533,0.35,138,348,0.4,0.47,136,164,0.85,33,141,174,123,75,1,169,323,970,0.51,15.06
Usman Garuba,14,167,25,37,2,6,0.33,23,31,0.74,0.7,9,18,0.5,15,25,40,6,12,4,7,20,61,0.68,13.48
Uvis Helmanis,20,316,27,59,20,43,0.47,7,16,0.44,0.63,19,25,0.76,14,28,42,8,11,0,20,56,93,0.66,22.22
Vadim Panin,31,519,27,70,18,53,0.34,9,17,0.53,0.51,6,8,0.83,15,49,64,26,16,2,25,49,78,0.53,25.38
Vaidas Kariniauskas,14,227,20,55,3,16,0.19,17,39,0.44,0.39,7,15,0.47,4,21,25,22,7,5,28,24,50,0.41,31.25
Valdas Vasylius,10,148,26,56,6,23,0.26,20,33,0.61,0.52,10,18,0.56,8,18,26,8,2,1,7,15,68,0.53,9.87
Valentin Pastal,3,29,3,9,3,7,0.43,0,2,0.0,0.5,1,2,0.5,0,1,1,1,1,0,2,6,10,0.51,16.84
Valeri Daineko,25,644,108,230,22,63,0.35,86,167,0.51,0.52,85,99,0.84,24,69,93,29,21,20,44,73,323,0.59,13.86
Valeri Likhodei,21,313,42,87,35,64,0.55,7,23,0.3,0.68,5,11,0.46,14,28,42,4,4,8,9,32,124,0.68,8.93
Valerio Spinelli,14,189,12,37,0,14,0.0,12,23,0.52,0.32,19,26,0.73,4,11,15,34,19,0,22,15,43,0.44,31.23
Vangelis Mantzaris,210,4260,297,803,203,572,0.35,94,231,0.41,0.5,115,170,0.64,96,428,524,447,133,5,176,512,912,0.52,16.7
Vangelis Sklavos,34,514,51,114,19,53,0.36,32,61,0.52,0.53,46,57,0.81,33,68,101,32,7,1,29,72,167,0.6,17.25
Vanja Marinkovic,27,402,59,135,23,70,0.33,36,65,0.55,0.52,30,36,0.83,6,22,28,11,11,0,26,34,171,0.57,14.7
Vasileios Karasev,19,578,64,135,21,57,0.37,43,78,0.55,0.55,62,79,0.78,7,27,34,60,22,3,41,73,211,0.62,19.45
Vasilije Micic,124,3015,434,972,155,420,0.37,279,552,0.51,0.53,200,248,0.85,40,222,262,576,111,8,315,292,1223,0.57,22.56
Vasily Zavoruev,13,68,5,14,5,12,0.42,0,2,0.0,0.54,0,2,0.0,4,3,7,3,4,0,3,7,15,0.5,16.78
Vassilis Charalampopoulos,18,163,11,22,5,11,0.45,6,11,0.55,0.61,8,11,0.71,5,21,26,14,4,3,9,10,35,0.65,25.11
Vassilis Kikilias,38,403,18,60,6,35,0.17,12,25,0.48,0.35,7,14,0.74,19,45,64,26,12,0,22,83,49,0.37,24.95
Vassilis Spanoulis,324,8792,1331,3199,484,1494,0.32,847,1705,0.5,0.49,1093,1392,0.79,78,527,605,1515,254,7,1020,712,4239,0.56,21.11
Vassilis Toliopoulos,10,53,5,17,4,13,0.31,1,4,0.25,0.41,1,2,0.5,0,3,3,9,2,1,1,9,15,0.42,5.3
Vassilis Xanthopoulos,25,229,8,27,1,15,0.07,7,12,0.58,0.31,6,11,0.33,2,17,19,27,8,0,15,38,23,0.36,32.02
Vedran Morovic,18,251,40,76,11,21,0.52,29,55,0.53,0.6,17,26,0.66,5,22,27,34,18,0,40,47,108,0.62,31.39
Vedran Princ,30,278,20,49,7,29,0.24,13,20,0.65,0.48,7,10,0.72,5,16,21,18,6,0,17,27,54,0.51,24.15
Vedran Vukusic,37,798,88,171,31,84,0.37,57,87,0.66,0.61,27,35,0.72,34,87,121,20,22,3,43,104,234,0.63,18.74
Veljko Mrsic,21,429,59,149,16,52,0.31,43,97,0.44,0.45,57,70,0.81,22,40,62,28,6,1,25,27,191,0.53,12.21
Veselin Petrovic,8,209,19,49,8,24,0.33,11,25,0.44,0.47,15,26,0.58,5,27,32,13,13,0,6,30,61,0.5,9.03
Victor Alexander,56,1473,298,554,10,27,0.37,288,527,0.55,0.55,116,164,0.7,94,220,314,39,49,8,94,160,722,0.58,13.05
Victor Claver,148,3306,354,738,124,318,0.39,230,420,0.55,0.56,170,208,0.84,155,445,600,193,118,51,146,271,1002,0.6,14.97
Victor Luengo,19,276,19,47,5,19,0.26,14,28,0.5,0.46,23,35,0.66,4,16,20,15,15,1,22,49,66,0.53,26.07
Victor Rudd,43,907,119,265,36,102,0.35,83,163,0.51,0.52,58,73,0.84,27,117,144,56,27,11,60,75,332,0.56,16.8
Victor Sada,166,2349,157,394,29,138,0.21,128,256,0.5,0.44,74,108,0.7,80,258,338,313,88,10,150,217,417,0.47,25.36
Victor Samnick,27,430,61,147,2,16,0.12,59,131,0.45,0.42,21,34,0.6,27,55,82,9,10,10,42,79,145,0.45,20.59
Vidas Ginevicius,79,1628,121,290,64,184,0.35,57,106,0.54,0.53,94,140,0.7,20,84,104,137,115,4,117,174,400,0.57,24.97
Viktor Keirou,7,29,2,4,1,2,0.5,1,2,0.5,0.62,6,7,0.86,0,3,3,1,1,0,2,4,11,0.78,22.03
Viktor Khryapa,240,4662,524,1088,171,459,0.37,353,629,0.56,0.56,228,313,0.71,181,889,1070,553,241,161,364,552,1447,0.59,22.9
Viktor Sanikidze,34,537,68,136,7,31,0.23,61,105,0.58,0.53,27,50,0.49,57,93,150,23,10,11,29,62,170,0.54,15.51
Vince Hunter,8,63,12,20,0,1,0.0,12,19,0.63,0.6,8,13,0.62,8,7,15,0,0,3,3,17,32,0.62,10.45
Vincenzo Esposito,1,26,5,10,2,4,0.5,3,6,0.5,0.6,2,2,1.0,0,2,2,0,1,0,5,4,14,0.64,31.49
Virgil Stanescu,14,344,52,106,5,12,0.42,47,94,0.5,0.51,35,45,0.78,31,53,84,6,17,4,20,49,144,0.57,13.72
Virginijus Praskevicius,56,1367,206,451,71,176,0.4,135,275,0.49,0.54,71,105,0.64,70,176,246,62,45,12,77,156,554,0.56,13.41
Vitaly Fridzon,195,3117,440,984,210,501,0.42,230,483,0.48,0.55,239,281,0.85,98,247,345,225,112,23,172,442,1329,0.6,13.44
Vitor Faverani,16,194,34,64,1,11,0.09,33,53,0.62,0.54,25,31,0.8,13,37,50,5,3,4,21,23,94,0.61,21.29
Vlad Moldoveanu,18,362,47,102,28,52,0.54,19,50,0.38,0.6,26,31,0.84,15,38,53,15,12,2,10,63,148,0.64,7.96
Vladan Alanovic,6,75,4,10,1,3,0.33,3,7,0.43,0.45,5,8,0.62,1,3,4,9,4,0,8,11,14,0.52,37.17
Vladimir Anzulovic,8,96,10,31,6,20,0.3,4,11,0.36,0.42,6,6,1.0,0,5,5,12,0,0,7,19,33,0.49,17.22
Vladimir Boisa,85,1940,243,585,67,215,0.31,176,370,0.48,0.47,150,236,0.63,109,186,295,58,54,7,79,279,703,0.51,10.29
Vladimir Dasic,28,551,70,177,19,58,0.33,51,119,0.43,0.45,27,45,0.67,26,73,99,24,27,3,36,49,186,0.47,15.46
Vladimir Dragicevic,10,279,66,103,0,1,0.0,66,102,0.65,0.64,15,26,0.58,24,43,67,15,6,9,15,25,147,0.64,11.59
Vladimir Dyachok,4,23,1,6,0,2,0.0,1,4,0.25,0.17,3,4,0.75,0,2,2,1,0,0,0,5,5,0.32,0.0
Vladimir Ivlev,17,98,10,22,0,2,0.0,10,20,0.5,0.45,1,4,0.25,9,7,16,2,2,0,5,27,21,0.44,17.39
Vladimir Jankovic,17,60,3,12,2,8,0.25,1,4,0.25,0.33,3,6,0.5,2,9,11,4,3,1,2,16,11,0.38,12.02
Vladimir Krstic,19,418,36,76,18,42,0.43,18,34,0.53,0.59,14,23,0.61,7,54,61,43,27,0,26,56,104,0.6,23.19
Vladimir Kuzmanovic,26,661,68,169,27,87,0.31,41,82,0.5,0.48,30,39,0.78,26,34,60,38,25,3,41,70,193,0.52,18.05
Vladimir Lucic,98,2397,301,608,79,217,0.36,222,391,0.57,0.56,200,246,0.79,77,259,336,107,84,21,87,228,881,0.62,10.83
Vladimir Micov,216,5677,793,1778,310,745,0.42,483,1033,0.47,0.53,318,409,0.74,124,544,668,452,153,32,291,408,2214,0.57,12.94
Vladimir Petrovic,12,406,70,133,23,49,0.47,47,84,0.56,0.61,31,46,0.67,14,53,67,32,22,3,30,38,194,0.63,16.37
Vladimir Stimac,78,1430,273,468,4,16,0.25,269,452,0.6,0.59,128,201,0.58,175,247,422,65,34,27,70,144,678,0.61,11.17
Vladimir Veremeenko,17,439,54,106,2,5,0.4,52,101,0.51,0.52,35,50,0.7,41,61,102,14,12,15,29,59,145,0.57,18.47
Vlado Ilievski,151,3818,430,1033,176,501,0.35,254,532,0.48,0.5,254,319,0.8,46,203,249,333,189,8,219,308,1290,0.55,15.73
Vlado Scepanovic,69,1522,201,433,101,235,0.43,100,198,0.51,0.58,165,200,0.81,22,61,83,78,41,3,103,123,668,0.64,16.51
Vlantimir Giankovits,49,1056,121,289,48,136,0.35,73,153,0.48,0.5,58,85,0.65,42,111,153,86,43,7,40,121,348,0.53,10.92
Vojdan Stojanovski,11,144,17,45,7,19,0.37,10,26,0.38,0.46,6,8,0.75,2,11,13,13,6,0,6,16,47,0.48,11.01
Von Wafer,3,50,8,16,1,3,0.33,7,13,0.54,0.53,6,7,0.86,0,4,4,3,1,0,8,3,23,0.6,29.54
Vonteego Cummings,44,1118,129,324,43,129,0.33,86,195,0.44,0.46,88,105,0.82,7,69,76,126,51,6,78,123,389,0.53,17.4
Vrbica Stefanov,103,2994,376,765,107,279,0.38,269,486,0.55,0.56,176,201,0.82,59,154,213,280,122,4,105,212,1035,0.61,10.96
Vujadin Subotic,3,25,1,6,0,5,0.0,1,1,1.0,0.17,2,2,1.0,0,1,1,1,2,0,0,3,4,0.29,0.0
Vule Avdalovic,71,1484,136,332,60,164,0.37,76,168,0.45,0.5,133,168,0.77,18,85,103,157,47,3,96,183,465,0.57,19.13
Vyacheslav Shushakov,6,27,4,11,1,4,0.25,3,7,0.43,0.41,0,2,0.0,1,3,4,6,1,0,2,13,9,0.38,14.41
Vyacheslav Zaytsev,54,432,36,79,4,19,0.21,32,60,0.53,0.48,20,30,0.75,14,44,58,41,17,17,22,85,96,0.52,19.26
Vytenis Cizauskas,16,142,15,30,5,12,0.42,10,18,0.56,0.58,1,4,0.25,3,14,17,19,7,0,16,24,36,0.57,33.5
Vytenis Lipkevicius,63,829,59,135,17,41,0.41,42,94,0.45,0.5,35,49,0.71,34,73,107,37,23,1,48,91,170,0.54,23.46
Wade Baldwin,24,403,46,109,8,30,0.27,38,79,0.48,0.46,31,49,0.63,8,35,43,44,12,1,36,54,131,0.5,21.61
Walsh Jordan,22,444,33,80,11,33,0.33,22,47,0.47,0.48,5,14,0.35,11,21,32,31,33,1,24,39,82,0.48,21.79
Walter Herrmann,50,936,138,304,45,124,0.36,93,180,0.52,0.53,48,71,0.72,37,103,140,28,20,5,42,67,369,0.55,11.13
Walter Hodge,15,314,42,100,12,40,0.3,30,60,0.5,0.48,21,23,0.91,4,15,19,46,6,2,25,35,117,0.53,18.5
Walter Palmer,3,67,15,36,1,6,0.17,14,30,0.47,0.43,4,6,0.67,4,9,13,1,3,2,14,10,35,0.45,26.6
Walter Tavares,28,642,85,125,0,1,0.0,85,124,0.69,0.68,32,49,0.65,62,137,199,22,17,61,29,61,202,0.69,16.52
Wayne Henry,15,105,9,30,2,13,0.15,7,17,0.41,0.33,2,4,0.5,8,7,15,3,5,0,6,22,22,0.35,15.89
Wendell Alexis,14,430,69,153,17,40,0.42,52,113,0.46,0.51,75,88,0.85,10,52,62,19,15,8,43,37,230,0.6,18.32
Wesley Johnson,28,440,32,92,15,57,0.26,17,35,0.49,0.43,14,21,0.67,13,55,68,16,17,14,11,51,93,0.46,9.8
Will Bynum,45,1089,165,370,44,135,0.33,121,235,0.51,0.51,112,139,0.81,14,85,99,127,56,4,118,115,486,0.56,21.49
Will Cherry,28,551,63,154,22,60,0.37,41,94,0.44,0.48,29,42,0.69,10,52,62,47,26,3,37,59,177,0.51,17.66
Will Clyburn,109,2936,491,1098,94,276,0.34,397,822,0.48,0.49,309,435,0.71,172,472,644,163,99,25,164,208,1385,0.54,11.28
Will Conroy,5,142,14,39,4,15,0.27,10,24,0.42,0.41,7,9,0.78,3,4,7,16,4,0,17,11,39,0.45,28.35
Will Daniels,22,432,75,166,17,46,0.37,58,120,0.48,0.5,36,52,0.71,27,51,78,18,10,7,31,48,203,0.54,14.1
Will McDonald,21,443,77,133,5,14,0.36,72,119,0.61,0.6,30,48,0.62,38,51,89,19,14,21,27,53,189,0.61,14.91
Will Solomon,82,2559,418,933,171,462,0.37,247,471,0.52,0.54,245,304,0.82,36,180,216,261,155,18,257,229,1252,0.59,19.41
Will Thomas,105,2510,309,643,60,208,0.29,249,435,0.57,0.53,145,188,0.77,160,271,431,119,71,12,62,133,823,0.57,7.87
William Phillips,4,61,12,17,2,4,0.5,10,13,0.77,0.76,7,10,0.7,6,4,10,3,3,2,6,15,33,0.77,21.9
William Soliman,14,183,23,41,1,3,0.33,22,38,0.58,0.57,12,22,0.55,18,12,30,3,8,11,15,26,59,0.58,22.84
Willie Burton,6,51,4,16,3,11,0.27,1,5,0.2,0.34,8,11,0.73,1,2,3,4,2,0,6,8,19,0.46,22.35
Willie Deane,5,83,6,27,1,4,0.25,5,23,0.22,0.24,3,5,0.6,2,3,5,5,1,0,13,14,16,0.27,30.81
Willie Reed,11,121,28,43,0,1,0.0,28,42,0.67,0.65,15,25,0.6,12,19,31,3,1,3,8,12,71,0.66,12.9
Wouter De Wilde,10,245,32,68,22,43,0.51,10,25,0.4,0.63,6,13,0.46,4,14,18,2,3,2,15,36,92,0.62,16.91
Xane D'Almeida,40,497,35,101,12,38,0.32,23,63,0.37,0.41,27,39,0.66,6,39,45,63,24,1,51,61,109,0.46,30.15
Xavi Rabaseda,66,930,94,228,38,127,0.3,56,101,0.55,0.5,34,47,0.72,23,87,110,48,49,10,57,99,260,0.52,18.65
Xavier Corosine,8,84,6,17,2,9,0.22,4,8,0.5,0.41,2,4,0.5,0,5,5,1,3,0,4,10,16,0.43,17.57
Yakhouba Diawara,11,203,32,74,9,25,0.36,23,49,0.47,0.49,9,16,0.56,11,18,29,4,6,1,14,22,82,0.51,14.73
Yann Bonato,27,594,64,156,18,53,0.34,46,103,0.45,0.47,69,88,0.78,29,43,72,39,19,1,53,70,215,0.55,21.4
Yannick Bokolo,28,595,55,125,11,44,0.25,44,81,0.54,0.48,17,35,0.49,15,36,51,84,25,3,48,65,138,0.49,25.48
Yannick Gagneur,7,98,7,13,4,8,0.5,3,5,0.6,0.69,4,5,0.8,3,7,10,5,3,0,8,6,22,0.72,34.48
Yassin Idbihi,47,778,126,237,1,4,0.25,125,233,0.54,0.53,43,62,0.68,72,101,173,17,10,11,52,113,296,0.56,16.44
Yoav Saffar,33,383,50,124,14,51,0.27,36,73,0.49,0.46,25,41,0.61,16,49,65,19,14,3,24,55,139,0.49,14.45
Yogev Ohayon,138,2990,297,733,96,253,0.38,201,480,0.42,0.47,117,176,0.7,63,281,344,450,145,8,206,295,807,0.5,20.27
Yohann Sangare,29,455,29,91,11,46,0.24,18,45,0.4,0.38,20,24,0.78,12,35,47,37,22,1,39,42,89,0.44,27.75
Yotam Halperin,154,2932,342,693,125,298,0.42,217,395,0.55,0.58,183,215,0.79,45,207,252,283,140,13,155,218,992,0.63,16.44
Yovel Zoosman,67,963,89,199,27,82,0.33,62,117,0.53,0.52,35,41,0.9,32,101,133,83,48,10,54,110,240,0.55,19.92
Yuri Vasilyev,21,300,23,49,2,6,0.33,21,43,0.49,0.49,16,22,0.73,17,21,38,8,10,12,12,55,64,0.55,16.98
Zabian Dowdell,9,166,32,70,5,16,0.31,27,54,0.5,0.49,9,11,0.86,0,13,13,19,11,0,13,8,78,0.52,14.8
Zach LeDay,58,1139,212,408,23,58,0.4,189,350,0.54,0.55,174,214,0.81,103,149,252,35,23,31,73,112,621,0.62,12.69
Zach Morley,24,576,60,136,10,25,0.4,50,111,0.45,0.48,26,28,0.93,19,79,98,53,22,5,31,63,156,0.53,17.29
Zakhar Pashutin,91,1189,138,315,38,118,0.32,100,197,0.51,0.5,48,86,0.51,41,126,167,88,66,7,54,154,362,0.51,13.27
Zan Sisko,7,108,14,23,5,10,0.5,9,13,0.69,0.72,4,4,1.0,3,4,7,17,10,0,14,14,37,0.75,36.12
Zanis Peiners,28,491,60,112,9,30,0.3,51,82,0.62,0.58,57,66,0.86,15,37,52,43,12,6,36,41,186,0.66,20.33
Zarko Cabarkapa,26,584,87,196,9,42,0.21,78,154,0.51,0.47,56,85,0.66,44,56,100,21,17,14,44,79,239,0.51,15.86
Zaza Pachulia,13,100,15,29,0,1,0.0,15,28,0.54,0.52,11,15,0.73,14,10,24,2,4,1,5,13,41,0.58,12.32
Zelimir Zagorac,7,33,3,5,0,1,0.0,3,4,0.75,0.6,2,6,0.33,3,3,6,0,2,0,2,7,8,0.52,20.75
Zoran Dragic,110,2187,314,725,92,299,0.31,222,426,0.52,0.5,158,220,0.73,99,176,275,121,80,9,114,240,878,0.53,12.18
Zoran Erceg,98,2100,288,675,126,347,0.36,162,328,0.49,0.52,193,226,0.84,89,259,348,81,70,15,84,182,895,0.58,9.79
Zoran Planinic,164,3966,560,1229,108,367,0.29,452,862,0.52,0.5,310,464,0.67,98,366,464,553,156,27,312,443,1538,0.54,17.88
Zoran Savic,23,367,69,133,20,56,0.36,49,77,0.64,0.59,36,59,0.56,15,46,61,19,13,1,39,68,194,0.61,19.7
Zoran Vrkic,6,50,7,12,2,3,0.67,5,9,0.56,0.67,4,6,0.67,1,10,11,1,2,0,3,6,20,0.68,17.01
Zygimantas Janavicius,17,209,17,46,5,16,0.31,12,30,0.4,0.42,4,11,0.42,4,13,17,19,5,0,22,28,43,0.42,30.2
