Player,Team,G,MP,FG,FGA,FG%,3P,3PA,3P%,2P,2PA,2P%,eFG%,FT,FTA,FT%,ORB,DRB,TRB,AST,STL,BLK,TOV,PF,PTS
Aaron Jackson,CSKA Moscow,34,737,96,185,0.519,31,65,0.477,65,120,0.542,0.603,36,49,0.735,10,39,49,121,25,2,56,56,259
Adam Hanga,Baskonia,33,925,127,283,0.449,40,119,0.336,87,164,0.53,0.519,54,81,0.667,31,115,146,79,42,22,45,77,348
Adrien Moerman,Darüşşafaka,33,717,103,260,0.396,40,120,0.333,63,140,0.45,0.473,20,26,0.769,37,131,168,28,29,6,22,76,266
Ahmet Duverioglu,Fenerbahçe,9,60,13,16,0.813,0,0,,13,16,0.813,0.813,4,6,0.667,7,5,12,1,1,4,3,9,30
Aleksandar Vezenkov,FC Barcelona Lassa,30,552,82,142,0.577,34,71,0.479,48,71,0.676,0.697,28,33,0.848,25,72,97,34,20,6,19,46,226
Aleksandr Karpukhin,UNICS,1,8,1,2,0.5,1,2,0.5,0,0,,0.75,0,0,,0,0,0,0,0,0,1,1,3
Aleksej Nikolic,Brose Bamberg,10,104,9,26,0.346,4,14,0.286,5,12,0.417,0.423,11,11,1,2,6,8,18,6,0,7,18,33
Alen Omic,Anadolu Efes,17,140,22,40,0.55,0,0,,22,40,0.55,0.55,6,16,0.375,17,9,26,7,3,0,9,25,50
Alessandro Gentile,Panathinaikos Superfoods,9,118,13,38,0.342,1,5,0.2,12,33,0.364,0.355,2,9,0.222,9,11,20,5,3,2,7,12,29
Alessandro Gentile,EA7 Emporio Armani Milan,9,206,38,83,0.458,3,14,0.214,35,69,0.507,0.476,18,32,0.563,12,15,27,22,10,3,20,19,97
Alex Kirk,Anadolu Efes,16,160,22,41,0.537,0,1,0,22,40,0.55,0.537,10,15,0.667,20,16,36,5,1,14,9,30,54
Alex Renfroe,FC Barcelona Lassa,17,301,24,58,0.414,12,31,0.387,12,27,0.444,0.517,7,7,1,10,26,36,28,17,0,24,34,67
Alex Tyus,Galatasaray,30,590,129,189,0.683,0,1,0,129,188,0.686,0.683,42,76,0.553,51,105,156,13,19,46,33,38,300
Andrea Bargnani,Baskonia,15,241,49,107,0.458,7,23,0.304,42,84,0.5,0.491,27,36,0.75,6,21,27,6,1,8,21,35,132
Andrea Cinciarini,EA7 Emporio Armani Milan,23,425,46,101,0.455,7,28,0.25,39,73,0.534,0.49,28,40,0.7,11,44,55,50,15,2,25,48,127
Andres Nocioni,Real Madrid,15,99,13,42,0.31,7,26,0.269,6,16,0.375,0.393,3,5,0.6,1,11,12,5,2,0,7,14,36
Andrew Goudelock,Maccabi Tel Aviv,20,573,127,250,0.508,49,107,0.458,78,143,0.545,0.606,42,46,0.913,4,49,53,57,5,0,34,31,345
Andrey Vorontsevich,CSKA Moscow,35,696,96,196,0.49,52,109,0.477,44,87,0.506,0.622,13,25,0.52,21,82,103,33,17,16,16,73,257
Antanas Kavaliauskas,Zalgiris,29,340,63,98,0.643,0,1,0,63,97,0.649,0.643,33,39,0.846,39,39,78,13,5,5,35,65,159
Ante Tomic,FC Barcelona Lassa,29,633,105,200,0.525,0,1,0,105,199,0.528,0.525,46,93,0.495,63,108,171,58,17,20,56,62,256
Ante Zizic,Darüşşafaka,20,437,72,111,0.649,0,0,,72,111,0.649,0.649,36,56,0.643,62,72,134,7,4,15,25,39,180
Anthony Bennett,Fenerbahçe,10,64,5,19,0.263,2,11,0.182,3,8,0.375,0.316,0,0,,0,9,9,2,3,1,3,3,12
Anthony Randolph,Real Madrid,34,721,127,254,0.5,29,79,0.367,98,175,0.56,0.557,63,81,0.778,44,130,174,39,13,36,40,61,346
Anton Ponkrashov,UNICS,10,203,26,62,0.419,9,22,0.409,17,40,0.425,0.492,3,6,0.5,3,18,21,38,11,0,27,15,64
Antonis Fotsis,Panathinaikos Superfoods,24,294,18,46,0.391,10,31,0.323,8,15,0.533,0.5,4,5,0.8,15,42,57,5,3,2,7,21,50
Artem Klimenko,UNICS,9,45,3,11,0.273,0,0,,3,11,0.273,0.273,5,6,0.833,2,8,10,1,0,0,6,11,11
Artsiom Parakhouski,UNICS,29,618,134,216,0.62,0,0,,134,216,0.62,0.62,59,75,0.787,75,74,149,11,10,37,24,67,327
Arturas Milaknis,Zalgiris,30,633,74,183,0.404,56,145,0.386,18,38,0.474,0.557,16,21,0.762,12,34,46,31,8,1,19,65,220
Augusto Lima,Zalgiris,30,446,58,101,0.574,0,0,,58,101,0.574,0.574,23,47,0.489,51,61,112,22,17,20,27,74,139
Austin Daye,Galatasaray,25,463,74,167,0.443,33,73,0.452,41,94,0.436,0.542,36,41,0.878,9,65,74,26,12,7,27,59,217
Awudu Abass,EA7 Emporio Armani Milan,23,369,34,81,0.42,16,38,0.421,18,43,0.419,0.519,21,25,0.84,17,27,44,12,9,6,15,45,105
Baris Hersek,Fenerbahçe,3,12,2,5,0.4,0,2,0,2,3,0.667,0.4,0,0,,0,0,0,0,1,0,0,3,4
Berk Ugurlu,Fenerbahçe,7,30,0,7,0,0,3,0,0,4,0,0,2,2,1,1,0,1,2,1,0,3,4,2
Birkan Batuk,Darüşşafaka,32,400,30,81,0.37,17,57,0.298,13,24,0.542,0.475,10,16,0.625,23,30,53,12,12,2,8,73,87
Blake Schilb,Galatasaray,27,690,104,209,0.498,22,71,0.31,82,138,0.594,0.55,20,23,0.87,28,76,104,107,19,3,42,36,250
Bobby Dixon,Fenerbahçe,34,862,130,314,0.414,78,201,0.388,52,113,0.46,0.538,48,53,0.906,19,74,93,106,35,0,67,84,386
Bogdan Bogdanovic,Fenerbahçe,22,615,108,216,0.5,46,107,0.43,62,109,0.569,0.606,59,69,0.855,9,75,84,80,25,6,52,54,321
Borisa Simanic,Crvena Zvezda mts,3,17,1,5,0.2,0,2,0,1,3,0.333,0.2,0,0,,1,2,3,1,0,0,0,3,2
Brad Oleson,FC Barcelona Lassa,24,519,50,102,0.49,20,58,0.345,30,44,0.682,0.588,8,10,0.8,11,33,44,47,14,5,20,40,128
Brad Wanamaker,Darüşşafaka,34,1138,180,402,0.448,56,145,0.386,124,257,0.482,0.517,153,177,0.864,17,90,107,158,51,3,102,94,569
Brandon Paul,Anadolu Efes,23,398,57,147,0.388,39,94,0.415,18,53,0.34,0.52,45,64,0.703,3,20,23,13,24,6,16,58,198
Branko Lazic,Crvena Zvezda mts,30,709,49,105,0.467,21,57,0.368,28,48,0.583,0.567,12,21,0.571,21,44,65,10,42,3,14,94,131
Brock Motum,Zalgiris,30,693,124,230,0.539,36,78,0.462,88,152,0.579,0.617,39,55,0.709,40,63,103,16,18,3,29,55,323
Bruno Cerella,EA7 Emporio Armani Milan,5,49,2,7,0.286,2,6,0.333,0,1,0,0.429,2,3,0.667,0,2,2,4,0,0,0,9,8
Bruno Fitipaldo,Galatasaray,16,225,29,65,0.446,16,38,0.421,13,27,0.481,0.569,12,14,0.857,1,3,4,38,4,0,22,38,86
Bryant Dunston,Anadolu Efes,35,1013,140,254,0.551,0,1,0,140,253,0.553,0.551,93,137,0.679,100,117,217,37,21,40,33,95,373
Bryce Cotton,Anadolu Efes,10,183,29,68,0.426,12,32,0.375,17,36,0.472,0.515,10,11,0.909,2,14,16,14,5,0,9,21,80
Can Korkmaz,Galatasaray,10,79,11,25,0.44,6,15,0.4,5,10,0.5,0.56,6,8,0.75,2,4,6,8,2,0,4,10,34
Can Maxim Mutaf,Anadolu Efes,11,72,7,21,0.333,7,17,0.412,0,4,0,0.5,0,0,,5,6,11,4,4,0,3,14,21
Cedi Osman,Anadolu Efes,35,649,88,215,0.409,36,106,0.34,52,109,0.477,0.493,37,47,0.787,29,68,97,26,21,3,19,63,249
Charles Jenkins,Crvena Zvezda mts,30,783,106,239,0.444,31,73,0.425,75,166,0.452,0.508,39,46,0.848,11,47,58,80,62,3,33,69,282
Chase Budinger,Baskonia,29,548,78,159,0.491,19,58,0.328,59,101,0.584,0.55,23,27,0.852,38,72,110,35,18,4,26,49,198
Chris Singleton,Panathinaikos Superfoods,33,932,127,256,0.496,48,110,0.436,79,146,0.541,0.59,95,127,0.748,62,133,195,38,41,34,46,107,397
Colton Iverson,Maccabi Tel Aviv,30,618,98,160,0.613,0,0,,98,160,0.613,0.613,44,77,0.571,63,96,159,17,24,7,40,87,240
Cory Higgins,CSKA Moscow,32,652,100,214,0.467,25,62,0.403,75,152,0.493,0.526,80,91,0.879,13,56,69,48,24,4,49,67,305
Coty Clarke,UNICS,14,305,30,77,0.39,8,21,0.381,22,56,0.393,0.442,18,21,0.857,12,47,59,17,8,4,19,20,86
Dagan Yivzori,Maccabi Tel Aviv,1,0,0,0,,0,0,,0,0,,,0,0,,0,0,0,0,0,0,0,0,0
Dairis Bertans,Darüşşafaka,32,514,63,136,0.463,33,66,0.5,30,70,0.429,0.585,46,55,0.836,8,13,21,42,6,2,24,47,205
Daniel Hackett,Olympiacos,11,160,17,48,0.354,4,15,0.267,13,33,0.394,0.396,17,22,0.773,1,16,17,18,5,0,2,22,55
Daniel Theis,Brose Bamberg,30,592,116,194,0.598,16,39,0.41,100,155,0.645,0.639,39,55,0.709,50,87,137,22,20,28,32,90,287
Danilo Andusic,UNICS,8,121,13,36,0.361,6,19,0.316,7,17,0.412,0.444,8,11,0.727,3,8,11,8,4,0,8,15,40
Darius Miller,Brose Bamberg,30,814,128,278,0.46,62,151,0.411,66,127,0.52,0.572,48,54,0.889,7,75,82,61,18,13,45,87,366
Davide Pascolo,EA7 Emporio Armani Milan,22,334,60,106,0.566,3,18,0.167,57,88,0.648,0.58,16,19,0.842,31,30,61,15,13,8,12,51,139
Demetris Nichols,Panathinaikos Superfoods,32,490,46,112,0.411,17,48,0.354,29,64,0.453,0.487,14,16,0.875,15,59,74,11,11,10,19,51,123
Deon Thompson,Crvena Zvezda mts,13,136,23,41,0.561,0,0,,23,41,0.561,0.561,10,20,0.5,8,11,19,6,4,4,3,15,56
Deon Thompson,Galatasaray,13,151,24,48,0.5,0,0,,24,48,0.5,0.5,7,11,0.636,12,15,27,9,7,5,6,26,55
Derrick Brown,Anadolu Efes,35,1025,167,340,0.491,17,58,0.293,150,282,0.532,0.516,79,103,0.767,58,135,193,77,36,18,55,65,430
Deshaun Thomas,Anadolu Efes,35,502,92,226,0.407,42,128,0.328,50,98,0.51,0.5,29,36,0.806,21,38,59,12,8,2,15,37,255
Devin Smith,Maccabi Tel Aviv,28,733,98,240,0.408,38,108,0.352,60,132,0.455,0.488,23,24,0.958,33,119,152,45,18,10,40,68,257
Diamon Simpson,Maccabi Tel Aviv,6,121,25,41,0.61,0,0,,25,41,0.61,0.61,5,15,0.333,14,26,40,7,9,6,4,16,55
Dimitrios Agravanis,Olympiacos,25,281,30,88,0.341,11,48,0.229,19,40,0.475,0.403,20,25,0.8,23,38,61,4,11,4,7,43,91
D.J. Seeley,Maccabi Tel Aviv,26,526,59,137,0.431,24,62,0.387,35,75,0.467,0.518,47,53,0.887,15,37,52,67,13,5,45,60,189
Dmitry Kulagin,CSKA Moscow,17,176,25,67,0.373,9,30,0.3,16,37,0.432,0.44,8,10,0.8,4,22,26,20,5,1,15,24,67
Dogus Balbay,Anadolu Efes,28,275,23,57,0.404,7,23,0.304,16,34,0.471,0.465,1,3,0.333,23,18,41,28,17,2,9,51,54
Dominic Waters,Olympiacos,21,225,34,69,0.493,6,19,0.316,28,50,0.56,0.536,12,13,0.923,3,12,15,31,4,0,19,47,86
Dontaye Draper,Real Madrid,29,390,27,70,0.386,12,42,0.286,15,28,0.536,0.471,14,17,0.824,6,23,29,41,23,1,19,51,80
Edgaras Ulanovas,Zalgiris,30,732,76,159,0.478,16,42,0.381,60,117,0.513,0.528,64,73,0.877,40,60,100,45,9,10,39,63,232
Ege Arar,Galatasaray,10,115,10,23,0.435,0,0,,10,23,0.435,0.435,2,2,1,11,19,30,4,3,4,5,19,22
Egehan Arna,Fenerbahçe,1,1,0,0,,0,0,,0,0,,,0,0,,0,0,0,0,0,0,0,1,0
Ekpe Udoh,Fenerbahçe,31,993,150,257,0.584,0,1,0,150,256,0.586,0.584,76,118,0.644,76,165,241,68,30,68,38,64,376
Eleftherios Bochoridis,Panathinaikos Superfoods,7,29,4,9,0.444,3,4,0.75,1,5,0.2,0.611,1,2,0.5,0,1,1,0,0,0,2,8,12
Elias Harris,Brose Bamberg,3,15,3,5,0.6,0,0,,3,5,0.6,0.6,1,2,0.5,1,0,1,0,1,1,2,4,7
Emir Preldzic,Galatasaray,18,292,32,82,0.39,15,39,0.385,17,43,0.395,0.482,13,19,0.684,12,32,44,42,18,0,11,21,92
Ender Arslan,Darüşşafaka,4,23,1,6,0.167,0,5,0,1,1,1,0.167,4,5,0.8,0,1,1,2,0,0,3,2,6
Erick Green,Olympiacos,36,737,130,294,0.442,48,120,0.4,82,174,0.471,0.524,49,60,0.817,10,58,68,34,25,5,27,52,357
Evgeny Voronov,UNICS,23,350,25,72,0.347,5,26,0.192,20,46,0.435,0.382,13,17,0.765,7,23,30,13,19,2,23,59,68
Fabien Causeur,Brose Bamberg,29,733,108,215,0.502,33,95,0.347,75,120,0.625,0.579,38,49,0.776,15,78,93,63,23,2,42,62,287
Felipe Reyes,Real Madrid,31,382,52,109,0.477,4,12,0.333,48,97,0.495,0.495,55,67,0.821,30,56,86,21,10,10,24,61,163
Furkan Aldemir,Darüşşafaka,30,292,18,48,0.375,0,0,,18,48,0.375,0.375,13,27,0.481,34,41,75,7,2,13,8,34,49
Furkan Korkmaz,Anadolu Efes,2,14,1,5,0.2,0,1,0,1,4,0.25,0.2,0,0,,0,1,1,1,3,0,0,1,2
Gal Mekel,Maccabi Tel Aviv,24,383,39,98,0.398,10,25,0.4,29,73,0.397,0.449,20,33,0.606,6,47,53,80,6,1,33,32,108
Giorgos Printezis,Olympiacos,32,812,156,333,0.468,27,67,0.403,129,266,0.485,0.509,70,100,0.7,43,120,163,33,21,5,22,36,409
Goksenin Koksal,Galatasaray,28,407,36,94,0.383,15,37,0.405,21,57,0.368,0.463,10,20,0.5,18,17,35,23,10,0,23,51,97
Gustavo Ayon,Real Madrid,36,743,160,229,0.699,0,0,,160,229,0.699,0.699,32,66,0.485,64,123,187,84,34,22,57,92,352
Guy Pnini,Maccabi Tel Aviv,29,367,27,74,0.365,13,47,0.277,14,27,0.519,0.453,8,15,0.533,9,37,46,36,10,0,13,25,75
Ilimane Diop,Baskonia,33,454,51,89,0.573,0,0,,51,89,0.573,0.573,32,43,0.744,23,67,90,15,8,18,23,100,134
Ioannis Papapetrou,Olympiacos,36,571,61,154,0.396,26,78,0.333,35,76,0.461,0.481,11,16,0.688,16,77,93,17,19,11,21,59,159
Isaiah Hartenstein,Zalgiris,5,16,2,5,0.4,0,2,0,2,3,0.667,0.4,1,1,1,0,4,4,1,0,0,2,2,5
Itay Segev,Maccabi Tel Aviv,7,59,7,11,0.636,0,0,,7,11,0.636,0.636,5,7,0.714,6,8,14,1,1,3,3,16,19
Jaka Blazic,Baskonia,33,450,58,146,0.397,24,62,0.387,34,84,0.405,0.479,14,25,0.56,19,50,69,15,15,0,19,45,154
Jamel McLean,EA7 Emporio Armani Milan,30,622,93,166,0.56,2,12,0.167,91,154,0.591,0.566,73,102,0.716,47,79,126,43,21,6,48,91,261
James Anderson,Darüşşafaka,34,764,116,285,0.407,47,136,0.346,69,149,0.463,0.489,33,49,0.673,27,95,122,45,20,14,35,58,312
James Augustine,CSKA Moscow,34,557,89,134,0.664,1,3,0.333,88,131,0.672,0.668,26,45,0.578,58,95,153,13,28,18,19,69,205
James Feldeine,Panathinaikos Superfoods,33,657,82,202,0.406,42,111,0.378,40,91,0.44,0.51,14,23,0.609,5,31,36,65,29,8,25,46,220
James Gist,Panathinaikos Superfoods,15,342,53,99,0.535,3,18,0.167,50,81,0.617,0.551,19,30,0.633,25,39,64,12,17,8,21,40,128
James Nunnally,Fenerbahçe,34,609,70,159,0.44,32,71,0.451,38,88,0.432,0.541,20,23,0.87,15,52,67,58,14,7,33,63,192
Jan Vesely,Fenerbahçe,34,831,130,231,0.563,0,3,0,130,228,0.57,0.563,68,122,0.557,55,99,154,49,35,19,49,94,328
Janis Strelnieks,Brose Bamberg,22,552,93,178,0.522,39,85,0.459,54,93,0.581,0.632,33,37,0.892,5,44,49,76,14,1,26,43,258
Jaycee Carroll,Real Madrid,36,613,114,237,0.481,60,139,0.432,54,98,0.551,0.608,41,45,0.911,9,44,53,27,8,2,24,76,329
Jayson Granger,Anadolu Efes,35,891,124,301,0.412,37,113,0.327,87,188,0.463,0.473,55,73,0.753,16,77,93,135,30,3,55,78,340
Jeff Ayres,CSKA Moscow,4,37,5,10,0.5,0,0,,5,10,0.5,0.5,14,16,0.875,9,10,19,0,0,3,1,6,24
Jeffery Taylor,Real Madrid,30,465,50,100,0.5,20,51,0.392,30,49,0.612,0.6,18,27,0.667,25,29,54,16,13,3,13,65,138
Jerel McNeal,Brose Bamberg,15,225,22,52,0.423,8,26,0.308,14,26,0.538,0.5,7,11,0.636,10,18,28,17,11,1,16,39,59
Quino Colom,UNICS,25,670,91,229,0.397,33,99,0.333,58,130,0.446,0.469,67,83,0.807,23,75,98,142,14,1,63,24,282
Joe Alexander,Maccabi Tel Aviv,17,188,25,49,0.51,7,11,0.636,18,38,0.474,0.582,7,9,0.778,6,19,25,7,3,4,14,22,64
Joel Freeland,CSKA Moscow,15,79,9,17,0.529,0,0,,9,17,0.529,0.529,5,13,0.385,5,13,18,1,3,1,0,19,23
Joey Dorsey,FC Barcelona Lassa,17,292,34,62,0.548,0,0,,34,62,0.548,0.548,25,44,0.568,46,61,107,14,9,5,30,41,93
Johannes Voigtmann,Baskonia,33,774,126,233,0.541,23,73,0.315,103,160,0.644,0.59,57,78,0.731,76,156,232,57,19,11,31,60,332
Jon Diebler,Galatasaray,29,551,61,121,0.504,49,91,0.538,12,30,0.4,0.707,18,21,0.857,9,45,54,42,15,0,21,50,189
Jonas Maciulis,Real Madrid,29,485,63,120,0.525,34,68,0.5,29,52,0.558,0.667,18,25,0.72,22,44,66,22,21,2,10,44,178
Jonathan Holmes,FC Barcelona Lassa,7,89,11,23,0.478,4,12,0.333,7,11,0.636,0.565,10,12,0.833,8,11,19,2,2,1,11,19,36
Josh Akognon,Baskonia,5,58,8,21,0.381,3,14,0.214,5,7,0.714,0.452,0,0,,1,2,3,6,2,0,3,11,19
Juan Carlos Navarro,FC Barcelona Lassa,16,247,30,94,0.319,16,56,0.286,14,38,0.368,0.404,15,16,0.938,1,16,17,28,7,0,28,20,91
Justin Dentmon,Galatasaray,8,163,33,76,0.434,18,45,0.4,15,31,0.484,0.553,14,17,0.824,2,8,10,18,6,1,7,22,98
Justin Doellman,FC Barcelona Lassa,15,299,42,94,0.447,15,28,0.536,27,66,0.409,0.527,18,19,0.947,10,37,47,18,13,2,14,23,117
K.C. Rivers,Panathinaikos Superfoods,33,913,133,296,0.449,71,169,0.42,62,127,0.488,0.569,32,41,0.78,14,67,81,25,25,2,28,83,369
Keith Langford,UNICS,28,953,192,470,0.409,57,157,0.363,135,313,0.431,0.469,168,202,0.832,20,76,96,104,21,6,68,50,609
Kenny Gabriel,Panathinaikos Superfoods,23,358,43,93,0.462,20,49,0.408,23,44,0.523,0.57,14,18,0.778,20,49,69,7,11,7,10,45,120
Kevin Pangos,Zalgiris,30,624,88,231,0.381,59,129,0.457,29,102,0.284,0.509,25,29,0.862,14,40,54,96,27,0,45,68,260
Khem Birch,Olympiacos,37,670,103,165,0.624,0,0,,103,165,0.624,0.624,63,98,0.643,83,126,209,12,18,36,38,74,269
Kim Tillie,Baskonia,32,616,84,153,0.549,22,54,0.407,62,99,0.626,0.621,31,34,0.912,46,76,122,34,23,6,23,67,221
Kostas Kaimakoglou,UNICS,19,438,33,85,0.388,12,42,0.286,21,43,0.488,0.459,11,14,0.786,10,55,65,28,9,3,22,44,89
Kostas Papanikolaou,Olympiacos,37,861,103,244,0.422,37,117,0.316,66,127,0.52,0.498,57,69,0.826,57,121,178,56,43,13,43,87,300
Kostas Sloukas,Fenerbahçe,29,758,89,200,0.445,30,70,0.429,59,130,0.454,0.52,60,69,0.87,9,53,62,130,18,5,73,68,268
Krunoslav Simon,EA7 Emporio Armani Milan,21,581,79,175,0.451,30,81,0.37,49,94,0.521,0.537,42,48,0.875,16,60,76,81,21,4,39,45,230
Kyle Hines,CSKA Moscow,35,716,106,163,0.65,0,0,,106,163,0.65,0.65,85,121,0.702,73,77,150,22,25,18,48,101,297
Latavious Williams,UNICS,30,520,88,148,0.595,0,1,0,88,147,0.599,0.595,32,44,0.727,64,88,152,16,10,14,25,80,208
Leo Westermann,Zalgiris,30,755,88,207,0.425,32,93,0.344,56,114,0.491,0.502,39,44,0.886,15,81,96,165,16,1,71,85,247
Leon Radosevic,Brose Bamberg,28,451,72,129,0.558,0,0,,72,129,0.558,0.558,26,41,0.634,26,48,74,18,10,9,28,49,170
Louis Olinde,Brose Bamberg,1,8,1,2,0.5,0,0,,1,2,0.5,0.5,0,0,,1,0,1,1,0,0,0,2,2
Lucca Staiger,Brose Bamberg,19,124,25,50,0.5,24,48,0.5,1,2,0.5,0.74,0,0,,3,14,17,4,3,0,4,16,74
Luigi Datome,Fenerbahçe,33,780,102,231,0.442,48,103,0.466,54,128,0.422,0.545,51,54,0.944,30,92,122,35,18,2,35,87,303
Luka Doncic,Real Madrid,35,696,85,196,0.434,39,105,0.371,46,91,0.505,0.533,65,77,0.844,33,123,156,148,30,6,62,45,274
Luka Mitrovic,Crvena Zvezda mts,28,440,49,109,0.45,3,18,0.167,46,91,0.505,0.463,15,28,0.536,23,42,65,38,13,3,35,31,116
Lukas Lekavicius,Zalgiris,30,543,95,212,0.448,25,74,0.338,70,138,0.507,0.507,41,54,0.759,11,47,58,104,19,1,50,65,256
Luke Harangody,Darüşşafaka,29,373,43,80,0.538,17,37,0.459,26,43,0.605,0.644,6,10,0.6,24,47,71,11,3,6,6,45,109
Maik Zirbes,Maccabi Tel Aviv,15,230,45,66,0.682,0,0,,45,66,0.682,0.682,32,41,0.78,17,28,45,4,5,2,21,40,122
Mantas Kalnietis,EA7 Emporio Armani Milan,26,505,70,161,0.435,28,76,0.368,42,85,0.494,0.522,20,30,0.667,7,52,59,76,20,2,43,33,188
Maodo Lo,Brose Bamberg,26,283,55,118,0.466,21,50,0.42,34,68,0.5,0.555,8,12,0.667,1,29,30,32,7,3,26,25,139
Marcus Eriksson,FC Barcelona Lassa,22,217,16,50,0.32,12,34,0.353,4,16,0.25,0.44,0,0,,7,20,27,7,8,3,11,26,44
Marcus Slaughter,Darüşşafaka,13,197,15,26,0.577,0,0,,15,26,0.577,0.577,12,21,0.571,13,21,34,7,7,5,12,40,42
Marko Banic,UNICS,24,322,51,83,0.614,0,0,,51,83,0.614,0.614,9,11,0.818,17,23,40,7,6,4,12,34,111
Marko Guduric,Crvena Zvezda mts,29,545,68,174,0.391,28,92,0.304,40,82,0.488,0.471,61,71,0.859,16,46,62,62,16,2,54,76,225
Marko Simonovic,Crvena Zvezda mts,30,802,130,279,0.466,57,146,0.39,73,133,0.549,0.568,61,74,0.824,22,85,107,21,24,4,24,48,378
Matt Lojeski,Olympiacos,26,557,89,180,0.494,37,88,0.42,52,92,0.565,0.597,43,52,0.827,21,59,80,42,13,9,26,33,258
Mehmet Yagmur,Darüşşafaka,12,29,1,6,0.167,1,5,0.2,0,1,0,0.25,0,0,,0,1,1,3,1,0,4,7,3
Melih Mahmutoglu,Fenerbahçe,20,208,26,61,0.426,21,48,0.438,5,13,0.385,0.598,6,6,1,2,8,10,11,5,0,4,21,79
Metin Turen,Darüşşafaka,1,0,0,0,,0,0,,0,0,,,0,0,,0,0,0,0,0,0,0,0,0
Mike James,Panathinaikos Superfoods,25,567,125,255,0.49,34,100,0.34,91,155,0.587,0.557,44,64,0.688,16,39,55,75,23,2,33,37,328
Mikhail Kulagin,CSKA Moscow,7,37,8,18,0.444,5,12,0.417,3,6,0.5,0.583,4,5,0.8,1,1,2,0,2,1,5,9,25
Milan Macvan,EA7 Emporio Armani Milan,28,627,91,187,0.487,21,56,0.375,70,131,0.534,0.543,31,39,0.795,44,80,124,40,12,1,31,47,234
Milko Bjelica,Crvena Zvezda mts,30,469,75,195,0.385,11,57,0.193,64,138,0.464,0.413,62,78,0.795,22,67,89,34,14,8,27,51,223
Milos Teodosic,CSKA Moscow,29,801,143,322,0.444,77,202,0.381,66,120,0.55,0.564,104,116,0.897,5,56,61,197,16,1,88,53,467
Miroslav Raduljica,EA7 Emporio Armani Milan,29,451,90,174,0.517,0,1,0,90,173,0.52,0.517,54,67,0.806,35,58,93,27,18,1,55,70,234
Moussa Diagne,FC Barcelona Lassa,8,79,5,13,0.385,0,0,,5,13,0.385,0.385,11,18,0.611,8,20,28,3,2,1,7,18,21
Nando De Colo,CSKA Moscow,28,757,176,341,0.516,43,101,0.426,133,240,0.554,0.579,139,145,0.959,4,77,81,110,28,2,91,61,534
Nate Wolters,Crvena Zvezda mts,27,407,74,170,0.435,19,50,0.38,55,120,0.458,0.491,25,32,0.781,7,50,57,59,18,1,33,43,192
Nemanja Dangubic,Crvena Zvezda mts,24,464,47,123,0.382,16,54,0.296,31,69,0.449,0.447,16,19,0.842,9,38,47,16,15,3,27,60,126
Nick Calathes,Panathinaikos Superfoods,33,897,132,326,0.405,28,114,0.246,104,212,0.491,0.448,30,60,0.5,29,102,131,183,49,5,69,73,322
Nicolas Laprovittola,Baskonia,14,129,13,49,0.265,7,31,0.226,6,18,0.333,0.337,5,6,0.833,2,10,12,31,4,0,18,19,38
Nicolo Melli,Brose Bamberg,30,877,128,255,0.502,36,83,0.434,92,172,0.535,0.573,54,73,0.74,38,184,222,69,22,20,51,77,346
Nikita Kurbanov,CSKA Moscow,35,671,60,138,0.435,16,48,0.333,44,90,0.489,0.493,76,85,0.894,33,99,132,39,20,16,33,83,212
Nikola Kalinic,Fenerbahçe,33,791,94,195,0.482,25,72,0.347,69,123,0.561,0.546,36,43,0.837,19,82,101,51,27,10,46,74,249
Nikola Milutinov,Olympiacos,36,457,62,107,0.579,0,1,0,62,106,0.585,0.579,36,52,0.692,62,55,117,21,12,29,36,79,160
Nikola Rebic,Crvena Zvezda mts,2,15,1,4,0.25,0,0,,1,4,0.25,0.25,0,0,,0,1,1,2,0,0,1,2,2
Nikos Pappas,Panathinaikos Superfoods,29,499,52,122,0.426,13,50,0.26,39,72,0.542,0.48,42,55,0.764,10,35,45,38,18,2,28,52,159
Nikos Zisis,Brose Bamberg,30,722,69,183,0.377,21,73,0.288,48,110,0.436,0.434,73,80,0.913,6,53,59,136,16,0,52,62,232
Nimrod Levi,Maccabi Tel Aviv,5,22,4,6,0.667,3,4,0.75,1,2,0.5,0.917,0,0,,0,3,3,0,0,0,2,3,11
Ognjen Dobric,Crvena Zvezda mts,13,69,9,22,0.409,2,12,0.167,7,10,0.7,0.455,1,3,0.333,1,5,6,2,4,0,5,7,21
Ognjen Kuzmic,Crvena Zvezda mts,30,621,112,204,0.549,0,0,,112,204,0.549,0.549,58,82,0.707,80,129,209,30,30,18,46,56,282
Oguz Savas,Darüşşafaka,8,51,9,15,0.6,0,0,,9,15,0.6,0.6,1,1,1,3,9,12,4,0,1,2,12,19
Okben Ulubay,Darüşşafaka,2,3,0,0,,0,0,,0,0,,,0,0,,0,0,0,0,0,0,0,0,0
Orhan Haciyeva,Galatasaray,4,13,0,2,0,0,1,0,0,1,0,0,0,0,,1,0,1,0,0,0,0,1,0
Orlando Johnson,UNICS,15,251,40,93,0.43,16,40,0.4,24,53,0.453,0.516,18,23,0.783,6,27,33,7,4,3,20,29,114
Othello Hunter,Real Madrid,35,584,112,173,0.647,0,2,0,112,171,0.655,0.647,41,60,0.683,58,101,159,21,17,9,30,71,265
Pablo Prigioni,Baskonia,3,26,0,2,0,0,0,,0,2,0,0,0,0,,1,4,5,6,2,0,3,3,0
Patric Young,Olympiacos,30,288,29,59,0.492,0,1,0,29,58,0.5,0.492,24,39,0.615,24,48,72,4,9,11,19,26,82
Patrick Heckmann,Brose Bamberg,28,349,29,67,0.433,16,33,0.485,13,34,0.382,0.552,9,13,0.692,2,32,34,22,8,0,16,36,83
Pau Ribas,FC Barcelona Lassa,2,20,3,7,0.429,3,6,0.5,0,1,0,0.643,0,0,,0,1,1,1,1,0,1,2,9
Paul Stoll,UNICS,14,221,16,49,0.327,13,37,0.351,3,12,0.25,0.459,6,8,0.75,7,21,28,38,14,0,17,26,51
Paulius Jankunas,Zalgiris,30,709,133,256,0.52,19,48,0.396,114,208,0.548,0.557,105,121,0.868,42,142,184,44,18,12,50,89,390
Paulius Valinskas,Zalgiris,5,9,2,3,0.667,0,1,0,2,2,1,0.667,2,2,1,0,0,0,2,0,0,1,1,6
Pavel Antipov,UNICS,28,524,56,112,0.5,38,75,0.507,18,37,0.486,0.67,9,14,0.643,18,37,55,19,18,5,9,55,159
Pero Antic,Fenerbahçe,31,420,37,111,0.333,27,80,0.338,10,31,0.323,0.455,29,39,0.744,14,61,75,19,13,2,11,56,130
Petteri Koponen,FC Barcelona Lassa,27,610,88,205,0.429,55,119,0.462,33,86,0.384,0.563,43,47,0.915,5,41,46,51,20,0,36,52,274
Quincy Miller,Maccabi Tel Aviv,4,77,10,30,0.333,4,11,0.364,6,19,0.316,0.4,4,4,1,3,10,13,3,2,3,5,11,28
Rafa Luz,Baskonia,32,249,29,54,0.537,9,18,0.5,20,36,0.556,0.62,4,6,0.667,6,20,26,49,13,1,25,42,71
Rakim Sanders,EA7 Emporio Armani Milan,24,548,116,243,0.477,39,96,0.406,77,147,0.524,0.558,30,45,0.667,21,63,84,28,27,5,30,60,301
Renaldas Seibutis,Zalgiris,30,375,25,73,0.342,5,24,0.208,20,49,0.408,0.377,19,25,0.76,6,32,38,28,10,2,18,46,74
Ricky Hickman,EA7 Emporio Armani Milan,30,749,92,238,0.387,38,109,0.349,54,129,0.419,0.466,81,101,0.802,13,64,77,100,25,3,69,63,303
Robertas Javtokas,Zalgiris,17,124,17,28,0.607,0,0,,17,28,0.607,0.607,5,8,0.625,11,12,23,4,1,0,9,21,39
Rodions Kurucs,FC Barcelona Lassa,1,3,1,2,0.5,0,1,0,1,1,1,0.5,0,0,,0,0,0,0,0,0,0,0,2
Rodrigue Beaubois,Baskonia,30,608,129,282,0.457,54,142,0.38,75,140,0.536,0.553,40,46,0.87,5,38,43,51,13,15,48,66,352
Rudy Fernandez,Real Madrid,32,748,72,210,0.343,43,133,0.323,29,77,0.377,0.445,21,28,0.75,24,67,91,103,38,4,38,57,208
Russ Smith,Galatasaray,7,65,16,45,0.356,2,12,0.167,14,33,0.424,0.378,15,22,0.682,2,6,8,6,2,1,6,10,49
Scottie Wilbekin,Darüşşafaka,31,781,116,270,0.43,69,171,0.404,47,99,0.475,0.557,60,69,0.87,20,36,56,100,44,1,55,71,361
Semen Antonov,CSKA Moscow,28,245,22,47,0.468,14,26,0.538,8,21,0.381,0.617,2,2,1,5,27,32,8,9,9,9,49,60
Semih Erden,Darüşşafaka,10,147,16,33,0.485,0,1,0,16,32,0.5,0.485,8,28,0.286,7,24,31,4,1,6,9,27,40
Sergio Llull,Real Madrid,33,918,177,425,0.416,73,221,0.33,104,204,0.51,0.502,116,137,0.847,10,50,60,194,24,3,77,64,543
Shane Larkin,Baskonia,33,954,140,345,0.406,49,143,0.343,91,202,0.45,0.477,102,128,0.797,18,71,89,187,42,8,92,80,431
Simone Fontecchio,EA7 Emporio Armani Milan,10,117,13,30,0.433,7,17,0.412,6,13,0.462,0.55,0,0,,6,9,15,8,5,1,5,21,33
Sinan Guler,Galatasaray,30,871,122,300,0.407,44,129,0.341,78,171,0.456,0.48,27,39,0.692,11,74,85,168,40,14,69,72,315
Sonny Weems,Maccabi Tel Aviv,19,514,89,175,0.509,17,52,0.327,72,123,0.585,0.557,26,37,0.703,3,60,63,65,18,2,58,49,221
Stefan Jovic,Crvena Zvezda mts,23,549,69,162,0.426,16,55,0.291,53,107,0.495,0.475,19,31,0.613,8,40,48,129,29,0,48,52,173
Stefan Peno,FC Barcelona Lassa,10,48,3,8,0.375,1,3,0.333,2,5,0.4,0.438,4,4,1,2,4,6,5,3,1,6,10,11
Stratos Perperoglou,FC Barcelona Lassa,22,460,53,139,0.381,19,53,0.358,34,86,0.395,0.45,15,22,0.682,8,61,69,34,16,4,23,33,140
Sylven Landesberg,Maccabi Tel Aviv,23,354,56,126,0.444,25,57,0.439,31,69,0.449,0.544,25,38,0.658,7,19,26,12,3,1,14,34,162
Tadas Sedekerskis,Baskonia,13,65,6,10,0.6,0,1,0,6,9,0.667,0.6,5,8,0.625,3,5,8,2,1,0,4,4,17
Thomas Heurtel,Anadolu Efes,35,920,168,368,0.457,35,104,0.337,133,264,0.504,0.504,72,83,0.867,8,51,59,197,29,0,89,76,443
Tibor Pleiss,Galatasaray,28,479,87,155,0.561,2,5,0.4,85,150,0.567,0.568,39,51,0.765,47,83,130,13,5,34,23,50,215
Tornike Shengelia,Baskonia,24,499,91,178,0.511,13,24,0.542,78,154,0.506,0.548,63,81,0.778,31,70,101,33,18,7,47,54,258
Trevor Cooney,Baskonia,1,5,0,1,0,0,1,0,0,0,,0,0,0,,0,0,0,1,0,0,0,0,0
Trey Thompkins,Real Madrid,26,356,56,118,0.475,29,61,0.475,27,57,0.474,0.597,17,21,0.81,14,48,62,6,8,6,15,58,158
Tyler Honeycutt,Anadolu Efes,35,858,110,274,0.401,33,109,0.303,77,165,0.467,0.462,68,100,0.68,69,187,256,70,40,30,63,64,321
Tyrese Rice,FC Barcelona Lassa,30,889,137,364,0.376,55,172,0.32,82,192,0.427,0.452,60,73,0.822,8,41,49,146,34,3,77,63,389
Vadim Panin,UNICS,26,474,27,63,0.429,18,48,0.375,9,15,0.6,0.571,4,6,0.667,11,42,53,23,15,2,24,45,76
Vangelis Mantzaris,Olympiacos,37,876,72,207,0.348,55,151,0.364,17,56,0.304,0.481,16,23,0.696,15,90,105,87,25,0,43,99,215
Vassilis Toliopoulos,Olympiacos,4,3,1,4,0.25,1,3,0.333,0,1,0,0.375,0,0,,0,0,0,0,0,0,0,1,3
Vassilis Charalampopoulos,Panathinaikos Superfoods,7,29,2,6,0.333,0,1,0,2,5,0.4,0.333,0,0,,1,1,2,0,0,0,1,2,4
Vassilis Spanoulis,Olympiacos,33,884,131,331,0.396,53,168,0.315,78,163,0.479,0.476,101,133,0.759,8,49,57,201,19,0,131,76,416
Victor Claver,FC Barcelona Lassa,27,594,56,122,0.459,23,61,0.377,33,61,0.541,0.553,28,36,0.778,23,95,118,34,25,8,33,45,163
Victor Rudd,Maccabi Tel Aviv,30,775,110,239,0.46,32,88,0.364,78,151,0.517,0.527,50,64,0.781,25,104,129,52,21,8,54,62,302
Viktor Khryapa,CSKA Moscow,32,435,45,118,0.381,7,38,0.184,38,80,0.475,0.411,23,28,0.821,18,98,116,57,27,11,26,51,120
Vitaly Fridzon,CSKA Moscow,35,453,70,137,0.511,25,60,0.417,45,77,0.584,0.602,43,50,0.86,13,29,42,27,20,10,28,70,208
Vitor Faverani,FC Barcelona Lassa,9,139,25,45,0.556,1,7,0.143,24,38,0.632,0.567,18,22,0.818,8,30,38,5,3,2,15,17,69
Vladimir Micov,Galatasaray,29,845,116,276,0.42,54,125,0.432,62,151,0.411,0.518,40,52,0.769,17,87,104,69,24,2,49,60,326
Vladimir Veremeenko,Brose Bamberg,25,200,24,43,0.558,0,0,,24,43,0.558,0.558,6,13,0.462,19,17,36,8,5,4,15,48,54
Will Clyburn,Darüşşafaka,34,958,167,389,0.429,24,83,0.289,143,306,0.467,0.46,85,124,0.685,51,123,174,44,29,10,49,66,443
Xavier Munford,FC Barcelona Lassa,5,34,2,9,0.222,1,3,0.333,1,6,0.167,0.278,0,0,,2,3,5,2,1,0,9,2,5
Ioannis Athinaiou,Olympiacos,9,42,1,7,0.143,0,3,0,1,4,0.25,0.143,1,2,0.5,1,2,3,5,0,0,6,8,3
Ioannis Bourousis,Panathinaikos Superfoods,33,600,77,193,0.399,16,55,0.291,61,138,0.442,0.44,89,113,0.788,57,102,159,34,15,18,59,80,259
Yogev Ohayon,Maccabi Tel Aviv,27,484,51,126,0.405,22,50,0.44,29,76,0.382,0.492,19,29,0.655,4,41,45,74,25,1,35,50,143
Yordan Minchev,Fenerbahçe,2,16,0,3,0,0,1,0,0,2,0,0,0,0,,0,2,2,0,0,0,3,1,0
Zoran Dragic,EA7 Emporio Armani Milan,23,442,61,137,0.445,16,54,0.296,45,83,0.542,0.504,24,33,0.727,21,29,50,17,15,4,26,58,162