Player,Team,G,MP,FG,FGA,FG%,3P,3PA,3P%,2P,2PA,2P%,eFG%,FT,FTA,FT%,ORB,DRB,TRB,AST,STL,BLK,TOV,PF,PTS
Adam Wojcik,Slask Wroclaw,14,374,73,135,0.541,15,36,0.417,58,99,0.586,0.596,43,63,0.683,18,34,52,9,10,17,37,42,204
Ainars Bagatskis,BC Zalgiris,12,288,32,83,0.386,23,57,0.404,9,26,0.346,0.524,27,30,0.9,6,25,31,9,7,0,11,35,114
AJ Guyton,Skipper Fortitudo Bologna,12,199,25,63,0.397,12,33,0.364,13,30,0.433,0.492,9,13,0.692,4,11,15,9,10,0,8,22,71
Alberto D'inca,Benetton Treviso,1,1,0,0,,0,0,,0,0,,,0,0,,0,0,0,0,0,0,1,0,0
Alejandro Montecchia,Pamesa Valencia,18,398,51,111,0.459,30,77,0.39,21,34,0.618,0.595,27,30,0.9,5,43,48,46,16,0,28,51,159
Aleksandar Ugrinoski,Cibona Zagreb,2,4,0,0,,0,0,,0,0,,,0,2,0,0,0,0,3,1,0,0,0,0
Alessandro Abbio,Pamesa Valencia,5,106,11,21,0.524,6,13,0.462,5,8,0.625,0.667,6,8,0.75,2,8,10,11,2,1,4,11,34
Alessandro Tonolli,Lottomatica Roma,14,305,22,52,0.423,18,40,0.45,4,12,0.333,0.596,13,18,0.722,9,40,49,10,8,8,12,49,75
Alex Righetti,Lottomatica Roma,9,198,28,55,0.509,11,22,0.5,17,33,0.515,0.609,11,11,1,4,14,18,5,6,2,12,32,78
Alexandr Bashminov,CSKA Moscow,10,98,15,26,0.577,0,1,0,15,25,0.6,0.577,5,10,0.5,12,19,31,3,3,10,1,12,35
Alexey Savrasenko,CSKA Moscow,17,201,28,43,0.651,0,0,,28,43,0.651,0.651,16,40,0.4,25,30,55,3,9,13,5,28,72
Aloysius Anagonye,KK Union Olimpija,18,340,50,101,0.495,1,4,0.25,49,97,0.505,0.5,21,29,0.724,40,47,87,9,13,11,20,58,122
Alper Yilmaz,Efes Pilsen,20,348,10,40,0.25,6,30,0.2,4,10,0.4,0.325,7,10,0.7,9,26,35,30,21,2,12,43,33
Anderson Varejao,FC Barcelona,18,389,52,97,0.536,3,16,0.188,49,81,0.605,0.552,32,55,0.582,31,60,91,10,19,12,25,44,139
Andre Owens,Adecco ASVEL Villeurbanne,8,226,29,74,0.392,5,18,0.278,24,56,0.429,0.426,14,19,0.737,5,26,31,27,12,1,20,21,77
Andrea Bargnani,Benetton Treviso,8,64,6,11,0.545,1,5,0.2,5,6,0.833,0.591,6,8,0.75,4,8,12,0,2,1,5,10,19
Andreas Glyniadakis,AEK Athens,14,195,18,31,0.581,0,0,,18,31,0.581,0.581,25,26,0.962,13,28,41,2,5,7,14,52,61
Andrej Stimac,Cibona Zagreb,13,159,11,34,0.324,5,24,0.208,6,10,0.6,0.397,7,10,0.7,6,12,18,3,7,0,6,19,34
Andres Nocioni,TAU Ceramica,16,413,78,163,0.479,20,53,0.377,58,110,0.527,0.54,44,58,0.759,19,73,92,24,14,15,39,49,220
Andrew Betts,TAU Ceramica,15,290,38,69,0.551,0,0,,38,69,0.551,0.551,26,47,0.553,19,45,64,11,9,4,20,44,102
Andrija Zizic,Cibona Zagreb,19,420,84,161,0.522,1,1,1,83,160,0.519,0.525,41,61,0.672,36,65,101,2,4,1,27,67,210
Andrius Lepinaitis,BC Zalgiris,1,4,1,1,1,0,0,,1,1,1,1,0,1,0,0,0,0,0,0,0,1,1,2
Ante Grgourevic,KK Krka,2,49,4,8,0.5,2,3,0.667,2,5,0.4,0.625,2,2,1,2,7,9,0,0,0,1,6,12
Anthony Parker,Maccabi Tel Aviv,21,737,109,201,0.542,24,49,0.49,85,152,0.559,0.602,94,108,0.87,18,103,121,74,26,8,34,50,336
Antoine Rigaudeau,Pamesa Valencia,19,562,98,185,0.53,28,73,0.384,70,112,0.625,0.605,58,66,0.879,5,29,34,43,30,1,39,61,282
Anton Kazarnovski,Maccabi Tel Aviv,1,1,0,0,,0,0,,0,0,,,1,2,0.5,0,0,0,0,0,0,0,0,1
Anton Yudin,CSKA Moscow,16,142,14,32,0.438,10,22,0.455,4,10,0.4,0.594,1,1,1,2,9,11,10,5,0,6,22,39
Antonio Granger,Efes Pilsen,20,686,112,237,0.473,51,126,0.405,61,111,0.55,0.58,39,51,0.765,24,57,81,31,24,8,25,46,314
Arda Vekiloglu,Fenerbahçe,11,121,10,28,0.357,2,10,0.2,8,18,0.444,0.393,1,1,1,7,4,11,3,4,0,8,15,23
Arriel McDonald,Panathinaikos,20,610,70,140,0.5,20,41,0.488,50,99,0.505,0.571,52,72,0.722,6,41,47,58,38,2,30,61,212
Artemios Kouvaris,Panathinaikos,1,2,0,0,,0,0,,0,0,,,0,0,,0,0,0,0,0,0,1,0,0
Artur Drozdov,Elan Bearnais Pau-Orthez,20,454,59,119,0.496,21,47,0.447,38,72,0.528,0.584,16,30,0.533,20,39,59,28,10,8,22,33,155
Arturas Javtokas,BC Zalgiris,13,148,16,36,0.444,0,0,,16,36,0.444,0.444,15,17,0.882,9,18,27,6,3,0,11,34,47
Arvydas Macijauskas,TAU Ceramica,20,612,119,242,0.492,40,101,0.396,79,141,0.56,0.574,111,122,0.91,10,40,50,42,32,4,45,48,389
Arvydas Sabonis,BC Zalgiris,18,509,107,191,0.56,15,41,0.366,92,150,0.613,0.599,71,102,0.696,43,150,193,43,18,29,36,46,300
Ashraf Amaya,Fenerbahçe,2,24,0,3,0,0,0,,0,3,0,0,1,2,0.5,1,6,7,0,1,0,1,9,1
Asier Arzallus,TAU Ceramica,1,1,0,1,0,0,0,,0,1,0,0,0,0,,0,0,0,0,0,0,0,0,0
Asier Garcia,Pamesa Valencia,13,129,19,43,0.442,11,21,0.524,8,22,0.364,0.57,5,10,0.5,4,13,17,5,3,2,5,17,54
Avraham Ben Chimol,Maccabi Tel Aviv,2,5,1,2,0.5,0,1,0,1,1,1,0.5,0,0,,0,0,0,1,0,0,0,0,2
Barisa Krasic,Cibona Zagreb,18,277,41,85,0.482,18,38,0.474,23,47,0.489,0.588,14,17,0.824,13,22,35,5,8,7,11,50,114
Berni Rodriguez,Unicaja Malaga,13,283,38,80,0.475,24,53,0.453,14,27,0.519,0.625,17,20,0.85,2,22,24,21,11,0,16,32,117
Blagota Sekulic,AEK Athens,13,190,24,43,0.558,3,6,0.5,21,37,0.568,0.593,9,20,0.45,11,18,29,3,3,4,8,33,60
Bootsy Thornton,Montepaschi Siena,22,686,95,234,0.406,27,74,0.365,68,160,0.425,0.464,86,114,0.754,36,72,108,57,40,0,46,67,303
Boris Gnjidic,KK Krka,10,171,19,47,0.404,9,24,0.375,10,23,0.435,0.5,13,16,0.813,8,4,12,8,12,2,11,28,60
Boris Gorenc,Olympiacos,20,448,60,120,0.5,9,32,0.281,51,88,0.58,0.538,41,59,0.695,15,33,48,24,13,1,23,40,170
Bradley Traina,Fenerbahçe,6,106,17,38,0.447,8,23,0.348,9,15,0.6,0.553,5,7,0.714,7,9,16,3,3,0,6,15,47
Branko Milisavljevic,Olympiacos,4,62,6,14,0.429,2,5,0.4,4,9,0.444,0.5,3,5,0.6,1,5,6,4,1,0,4,10,17
Bruno Morabito,Lottomatica Roma,1,1,0,0,,0,0,,0,0,,,0,0,,0,0,0,0,0,0,1,0,0
Bruno Sundov,Maccabi Tel Aviv,4,19,4,5,0.8,0,0,,4,5,0.8,0.8,2,2,1,3,1,4,0,0,0,1,5,10
Cal Bowdler,Lottomatica Roma,12,115,17,31,0.548,1,2,0.5,16,29,0.552,0.565,11,16,0.688,8,20,28,1,6,4,7,15,46
Carlos Cabezas,Unicaja Malaga,14,337,39,84,0.464,10,38,0.263,29,46,0.63,0.524,24,35,0.686,6,19,25,20,11,0,16,28,112
Carlos Delfino,Skipper Fortitudo Bologna,21,651,92,222,0.414,27,80,0.338,65,142,0.458,0.475,49,63,0.778,37,89,126,47,35,3,36,58,260
Carlton Myers,Lottomatica Roma,11,341,48,131,0.366,29,75,0.387,19,56,0.339,0.477,34,39,0.872,6,21,27,32,12,0,33,35,159
Cesar Bravo,FC Barcelona,1,1,0,1,0,0,0,,0,1,0,0,0,0,,0,0,0,0,0,0,0,1,0
Charles Evans,Alba Berlin,8,133,13,27,0.481,2,10,0.2,11,17,0.647,0.519,7,7,1,2,6,8,11,6,0,14,13,35
Christian Drejer,FC Barcelona,4,43,6,15,0.4,3,6,0.5,3,9,0.333,0.5,1,2,0.5,4,2,6,2,1,0,3,9,16
Christos Harissis,Olympiacos,20,462,48,123,0.39,24,71,0.338,24,52,0.462,0.488,32,40,0.8,15,30,45,48,14,1,29,65,152
Christos Tapoutos,AEK Athens,13,329,40,98,0.408,8,23,0.348,32,75,0.427,0.449,18,22,0.818,6,32,38,20,3,2,24,28,106
Chuck Kornegay,Unicaja Malaga,14,333,37,67,0.552,0,0,,37,67,0.552,0.552,30,38,0.789,28,47,75,2,6,13,28,36,104
Clarence Gilbert,KK Krka,11,304,38,101,0.376,26,68,0.382,12,33,0.364,0.505,11,17,0.647,3,21,24,19,16,0,14,25,113
Cory Alexander,Lottomatica Roma,10,295,40,92,0.435,14,45,0.311,26,47,0.553,0.511,27,42,0.643,4,18,22,27,14,3,21,34,121
Cyril Julian,Elan Bearnais Pau-Orthez,18,374,61,119,0.513,0,0,,61,119,0.513,0.513,39,51,0.765,34,51,85,9,13,9,22,53,161
Dainius Salenga,BC Zalgiris,20,550,57,143,0.399,16,72,0.222,41,71,0.577,0.455,28,39,0.718,15,33,48,40,20,3,24,41,158
Dalibor Bagaric,Olympiacos,20,436,59,103,0.573,0,3,0,59,100,0.59,0.573,21,40,0.525,25,75,100,12,8,17,32,52,139
Damir Markota,Cibona Zagreb,1,2,1,2,0.5,0,1,0,1,1,1,0.5,0,0,,0,1,1,0,0,0,0,0,2
Danilo Smigic,KK Union Olimpija,2,6,0,1,0,0,0,,0,1,0,0,1,2,0.5,0,2,2,0,0,0,0,2,1
Darjus Lavrinovic,BC Zalgiris,2,35,8,14,0.571,1,3,0.333,7,11,0.636,0.607,6,6,1,1,4,5,2,0,3,1,6,23
Darrell Tucker,KK Union Olimpija,2,7,0,2,0,0,2,0,0,0,,0,1,2,0.5,0,1,1,1,2,0,1,2,1
Darren Phillip,Unicaja Malaga,11,167,22,29,0.759,1,3,0.333,21,26,0.808,0.776,19,30,0.633,19,15,34,12,6,3,8,16,64
Darryl Middleton,Panathinaikos,20,454,58,98,0.592,0,0,,58,98,0.592,0.592,32,38,0.842,25,22,47,13,22,1,30,66,148
David Andersen,Montepaschi Siena,21,426,83,165,0.503,0,3,0,83,162,0.512,0.503,25,39,0.641,33,64,97,15,13,6,28,54,191
David Bluthenthal,Maccabi Tel Aviv,17,173,39,64,0.609,12,26,0.462,27,38,0.711,0.703,15,19,0.789,6,17,23,6,3,1,7,38,105
David Frigout,Adecco ASVEL Villeurbanne,13,226,29,41,0.707,0,0,,29,41,0.707,0.707,10,21,0.476,18,32,50,3,3,3,17,30,68
David Vanterpool,Montepaschi Siena,22,625,94,215,0.437,25,69,0.362,69,146,0.473,0.495,90,120,0.75,35,58,93,75,53,1,57,79,303
Davide Bonora,Lottomatica Roma,14,249,12,31,0.387,4,17,0.235,8,14,0.571,0.452,8,9,0.889,3,9,12,17,8,0,3,25,36
Davor Kus,Cibona Zagreb,20,394,31,76,0.408,10,29,0.345,21,47,0.447,0.474,37,49,0.755,4,21,25,39,11,2,23,40,109
Dejan Bodiroga,FC Barcelona,17,549,87,160,0.544,5,16,0.313,82,144,0.569,0.559,73,93,0.785,14,62,76,40,17,1,42,35,252
Dejan Koturovic,TAU Ceramica,4,62,9,15,0.6,0,0,,9,15,0.6,0.6,4,6,0.667,3,6,9,0,1,4,9,10,22
Dejan Tomasevic,Pamesa Valencia,17,529,81,141,0.574,0,1,0,81,140,0.579,0.574,28,62,0.452,61,87,148,66,36,4,47,36,190
DeJuan Collins,Alba Berlin,14,470,78,167,0.467,14,47,0.298,64,120,0.533,0.509,63,81,0.778,16,43,59,35,18,3,41,47,233
Denis Marconato,Benetton Treviso,19,486,72,118,0.61,0,0,,72,118,0.61,0.61,54,69,0.783,47,103,150,14,15,24,20,51,198
Deon Thomas,Maccabi Tel Aviv,21,258,48,83,0.578,0,2,0,48,81,0.593,0.578,32,41,0.78,23,34,57,13,10,8,22,69,128
Derek Hood,Adecco ASVEL Villeurbanne,10,217,28,72,0.389,0,3,0,28,69,0.406,0.389,11,19,0.579,23,37,60,12,9,1,21,37,67
Derrick Phelps,Slask Wroclaw,1,24,2,3,0.667,1,1,1,1,2,0.5,0.833,5,6,0.833,2,1,3,3,1,0,0,4,10
Derrick Sharp,Maccabi Tel Aviv,21,357,36,77,0.468,28,61,0.459,8,16,0.5,0.649,22,24,0.917,3,15,18,19,18,0,15,64,122
Dimitrios Misiakos,AEK Athens,6,46,2,6,0.333,0,2,0,2,4,0.5,0.333,1,2,0.5,1,0,1,2,1,0,2,6,5
Dimitrios Papanikolaou,Panathinaikos,15,186,28,50,0.56,3,7,0.429,25,43,0.581,0.59,19,35,0.543,8,24,32,7,5,1,4,26,78
Dimos Dikoudis,Pamesa Valencia,17,377,71,138,0.514,8,23,0.348,63,115,0.548,0.543,43,75,0.573,38,47,85,14,12,4,16,45,193
Djuro Ostojic,Partizan,14,468,65,105,0.619,1,2,0.5,64,103,0.621,0.624,55,92,0.598,56,45,101,25,12,6,38,50,186
Dominik Tomczyk,Slask Wroclaw,14,374,53,102,0.52,26,51,0.51,27,51,0.529,0.647,31,39,0.795,18,48,66,12,17,5,19,42,163
Doremus Bennerman,Lottomatica Roma,11,216,23,48,0.479,12,28,0.429,11,20,0.55,0.604,13,14,0.929,2,7,9,11,4,0,15,18,71
Dragan Lukovski,Elan Bearnais Pau-Orthez,19,564,57,143,0.399,20,54,0.37,37,89,0.416,0.469,114,133,0.857,9,34,43,84,23,3,48,39,248
Dragan Tarlac,CSKA Moscow,19,304,33,59,0.559,0,0,,33,59,0.559,0.559,37,55,0.673,23,33,56,11,4,3,21,36,103
Dusan Jelic,TAU Ceramica,8,77,10,22,0.455,0,0,,10,22,0.455,0.455,6,10,0.6,4,15,19,4,2,1,2,15,26
Dusan Kecman,Partizan,13,374,50,100,0.5,18,44,0.409,32,56,0.571,0.59,43,57,0.754,16,42,58,22,21,1,29,50,161
Dusan Sakota,Panathinaikos,2,8,0,2,0,0,1,0,0,1,0,0,0,0,,0,0,0,1,1,0,0,0,0
Dusan Vukcevic,Montepaschi Siena,22,317,39,95,0.411,18,49,0.367,21,46,0.457,0.505,22,24,0.917,2,29,31,24,12,4,18,36,118
Dzenan Rahimic,KK Union Olimpija,18,421,85,163,0.521,7,16,0.438,78,147,0.531,0.543,46,75,0.613,37,54,91,3,12,0,22,53,223
Ed Cota,BC Zalgiris,20,726,98,195,0.503,20,43,0.465,78,152,0.513,0.554,52,69,0.754,26,47,73,113,32,2,56,52,268
Efthimios Rentzias,Fenerbahçe,17,388,57,130,0.438,18,53,0.34,39,77,0.506,0.508,26,36,0.722,20,47,67,11,8,15,14,35,158
Egor Vyaltsev,CSKA Moscow,4,28,3,9,0.333,1,7,0.143,2,2,1,0.389,0,0,,0,2,2,4,1,0,5,4,7
Ender Arslan,Efes Pilsen,20,484,46,139,0.331,32,93,0.344,14,46,0.304,0.446,34,49,0.694,2,24,26,75,29,0,35,43,158
Erazem Lorbek,Skipper Fortitudo Bologna,22,235,31,54,0.574,2,5,0.4,29,49,0.592,0.593,13,24,0.542,20,30,50,9,12,8,11,35,77
Ermal Kuqo,Efes Pilsen,20,396,78,148,0.527,0,2,0,78,146,0.534,0.527,21,32,0.656,36,49,85,12,14,2,28,74,177
Fabien Dubos,Elan Bearnais Pau-Orthez,11,154,25,49,0.51,3,15,0.2,22,34,0.647,0.541,14,19,0.737,7,20,27,7,0,2,8,27,67
Fabricio Oberto,Pamesa Valencia,18,491,106,168,0.631,0,0,,106,168,0.631,0.631,28,67,0.418,31,70,101,43,14,11,36,61,240
Fatih Solak,Fenerbahçe,11,113,11,23,0.478,0,0,,11,23,0.478,0.478,6,14,0.429,14,9,23,2,0,6,9,22,28
Federico Kammerichs,Pamesa Valencia,15,198,22,63,0.349,4,21,0.19,18,42,0.429,0.381,19,27,0.704,21,28,49,12,4,5,10,16,67
Florent Pietrus,Elan Bearnais Pau-Orthez,19,551,69,132,0.523,9,18,0.5,60,114,0.526,0.557,48,66,0.727,43,65,108,24,22,17,40,62,195
Fragiskos Alvertis,Panathinaikos,16,381,65,137,0.474,30,70,0.429,35,67,0.522,0.584,19,23,0.826,11,20,31,18,5,1,19,39,179
Francesco Corradini,Benetton Treviso,1,2,0,0,,0,0,,0,0,,,0,0,,0,0,0,1,0,0,0,0,0
Fred House,Partizan,13,459,67,187,0.358,13,63,0.206,54,124,0.435,0.393,54,82,0.659,27,52,79,17,44,5,34,51,201
Frederic Fauthoux,Elan Bearnais Pau-Orthez,20,368,32,67,0.478,26,52,0.5,6,15,0.4,0.672,29,33,0.879,4,22,26,48,9,0,22,47,119
Frederic Weis,Unicaja Malaga,6,62,7,10,0.7,0,0,,7,10,0.7,0.7,2,4,0.5,6,7,13,1,1,5,5,15,16
Gauthier Darrigand,Elan Bearnais Pau-Orthez,6,36,3,4,0.75,2,2,1,1,2,0.5,1,0,0,,0,1,1,1,1,0,7,8,8
George Tsintsadze,CSKA Moscow,1,10,0,2,0,0,2,0,0,0,,0,0,0,,0,0,0,2,0,0,1,1,0
Georgios Giannouzakos,Olympiacos,14,148,10,30,0.333,6,19,0.316,4,11,0.364,0.433,0,2,0,3,14,17,11,3,0,4,20,26
Georgios Kalaitzis,Panathinaikos,17,301,21,47,0.447,14,28,0.5,7,19,0.368,0.596,14,24,0.583,11,21,32,17,11,0,18,46,70
Gerald Brown,Partizan,14,455,63,135,0.467,13,33,0.394,50,102,0.49,0.515,38,46,0.826,10,40,50,32,15,1,25,39,177
German Gabriel,Unicaja Malaga,14,141,18,35,0.514,5,9,0.556,13,26,0.5,0.586,14,20,0.7,15,22,37,5,5,2,11,26,55
Giacomo Galanda,Montepaschi Siena,21,470,53,117,0.453,22,55,0.4,31,62,0.5,0.547,19,25,0.76,21,50,71,12,22,5,27,72,147
Gianluca Basile,Skipper Fortitudo Bologna,17,500,65,164,0.396,41,106,0.387,24,58,0.414,0.521,35,42,0.833,7,37,44,49,22,0,25,49,206
Gianmarco Pozzecco,Skipper Fortitudo Bologna,22,442,51,94,0.543,15,35,0.429,36,59,0.61,0.622,64,73,0.877,10,26,36,100,19,0,49,61,181
Giannis Gagaloudis,Panathinaikos,2,11,3,4,0.75,3,4,0.75,0,0,,1.125,2,2,1,0,0,0,1,1,0,2,4,11
Giedrius Gustas,BC Zalgiris,19,283,46,108,0.426,22,50,0.44,24,58,0.414,0.528,18,21,0.857,6,5,11,19,11,1,12,46,132
Gino Cuccarolo,Benetton Treviso,1,1,0,0,,0,0,,0,0,,,0,0,,0,0,0,0,0,0,0,0,0
Giorgos Diamantopoulos,Olympiacos,15,368,60,107,0.561,16,33,0.485,44,74,0.595,0.636,50,63,0.794,15,16,31,22,12,3,16,29,186
Giorgos Printezis,Olympiacos,3,3,1,1,1,0,0,,1,1,1,1,0,0,,1,0,1,0,0,0,0,1,2
Giorgos Tsiaras,AEK Athens,6,60,6,12,0.5,1,4,0.25,5,8,0.625,0.542,5,6,0.833,2,11,13,1,4,1,2,15,18
Goran Cakic,Partizan,14,188,19,49,0.388,2,23,0.087,17,26,0.654,0.408,7,10,0.7,11,15,26,2,6,2,6,34,47
Goran Jurak,Olympiacos,20,524,57,120,0.475,4,16,0.25,53,104,0.51,0.492,35,62,0.565,32,65,97,28,21,4,31,77,153
Goran Nikolic,Efes Pilsen,19,433,68,117,0.581,0,2,0,68,115,0.591,0.581,17,27,0.63,35,83,118,20,14,12,18,36,153
Gregor Fucka,FC Barcelona,12,301,52,93,0.559,1,6,0.167,51,87,0.586,0.565,22,38,0.579,19,38,57,12,13,11,15,32,127
Guilherme Giovannoni,Benetton Treviso,19,367,47,96,0.49,20,46,0.435,27,50,0.54,0.594,19,22,0.864,8,43,51,23,24,3,16,43,133
Gur Shelef,Maccabi Tel Aviv,19,175,13,25,0.52,0,2,0,13,23,0.565,0.52,20,24,0.833,4,20,24,18,5,2,9,29,46
Haluk Yildirim,Fenerbahçe,11,260,27,58,0.466,13,34,0.382,14,24,0.583,0.578,11,14,0.786,7,19,26,21,8,2,14,35,78
Hanno Mottola,Skipper Fortitudo Bologna,22,480,82,173,0.474,16,46,0.348,66,127,0.52,0.52,58,66,0.879,22,62,84,9,17,8,31,80,238
Haris Mujezinovic,Panathinaikos,14,235,30,70,0.429,7,23,0.304,23,47,0.489,0.479,25,35,0.714,22,18,40,8,5,1,16,42,92
Harold Mrazek,Adecco ASVEL Villeurbanne,14,347,31,59,0.525,25,44,0.568,6,15,0.4,0.737,3,4,0.75,3,18,21,18,17,1,21,33,90
Herve Toure,Adecco ASVEL Villeurbanne,14,199,27,65,0.415,10,30,0.333,17,35,0.486,0.492,2,5,0.4,9,16,25,11,11,9,18,23,66
Horace Jenkins,AEK Athens,12,406,82,164,0.5,24,71,0.338,58,93,0.624,0.573,53,65,0.815,4,18,22,40,22,3,37,25,241
Ibrahim Kutluay,Fenerbahçe,19,564,81,192,0.422,47,111,0.423,34,81,0.42,0.544,44,61,0.721,9,42,51,25,18,0,32,46,253
Ignacio Rodriguez,FC Barcelona,16,210,14,40,0.35,6,23,0.261,8,17,0.471,0.425,10,14,0.714,2,19,21,26,14,1,12,13,44
Igor Ivaskovic,KK Krka,2,18,1,5,0.2,1,3,0.333,0,2,0,0.3,2,2,1,1,1,2,2,0,0,2,4,5
Ioannis Kalampokis,Olympiacos,12,92,5,15,0.333,0,4,0,5,11,0.455,0.333,10,14,0.714,1,14,15,6,3,0,2,19,20
Jaka Lakovic,Panathinaikos,20,586,78,174,0.448,34,95,0.358,44,79,0.557,0.546,77,91,0.846,10,32,42,47,26,1,37,45,267
Jason Gardner,KK Krka,2,35,4,8,0.5,3,6,0.5,1,2,0.5,0.688,4,6,0.667,1,2,3,7,1,0,2,4,15
Javi Buesa,TAU Ceramica,7,23,3,7,0.429,1,5,0.2,2,2,1,0.5,0,0,,0,1,1,0,0,0,1,6,7
Jose Antonio Paraiso,Pamesa Valencia,18,389,45,75,0.6,13,34,0.382,32,41,0.78,0.687,28,40,0.7,14,36,50,12,5,0,15,25,131
Jermaine Jackson,Benetton Treviso,2,71,12,17,0.706,1,2,0.5,11,15,0.733,0.735,7,9,0.778,1,3,4,12,6,0,4,5,32
Jeryl Sasser,Elan Bearnais Pau-Orthez,3,20,2,7,0.286,1,2,0.5,1,5,0.2,0.357,1,2,0.5,2,2,4,2,0,0,0,1,6
Johan Petro,Elan Bearnais Pau-Orthez,7,46,7,16,0.438,0,1,0,7,15,0.467,0.438,1,2,0.5,3,6,9,0,3,1,1,12,15
John Best,Alba Berlin,14,449,57,119,0.479,21,54,0.389,36,65,0.554,0.567,19,21,0.905,18,41,59,24,18,0,23,48,154
Johnny Branch,Lottomatica Roma,4,42,4,7,0.571,2,5,0.4,2,2,1,0.714,3,3,1,0,2,2,3,1,0,3,7,13
Jonathan Aka,Adecco ASVEL Villeurbanne,1,2,0,1,0,0,0,,0,1,0,0,0,0,,0,2,2,0,0,0,1,2,0
Jorge Garbajosa,Benetton Treviso,18,509,94,181,0.519,25,61,0.41,69,120,0.575,0.588,35,49,0.714,26,78,104,19,31,11,25,42,248
Jose Amador,Pamesa Valencia,1,1,0,0,,0,0,,0,0,,,1,2,0.5,0,0,0,0,0,0,0,1,1
Jose Calderon,TAU Ceramica,19,410,39,83,0.47,15,37,0.405,24,46,0.522,0.56,44,53,0.83,8,19,27,38,21,4,27,39,137
Joseph Blair,Fenerbahçe,17,583,88,141,0.624,0,3,0,88,138,0.638,0.624,44,90,0.489,43,120,163,24,22,16,37,42,220
Josip Jerko Vrankovic,Cibona Zagreb,11,248,34,62,0.548,15,30,0.5,19,32,0.594,0.669,6,11,0.545,7,30,37,12,5,2,9,23,89
Josip Sesar,Cibona Zagreb,15,242,28,65,0.431,14,46,0.304,14,19,0.737,0.538,10,18,0.556,4,19,23,17,8,1,18,31,80
Josko Poljak,Cibona Zagreb,20,306,32,71,0.451,0,1,0,32,70,0.457,0.451,24,39,0.615,24,66,90,4,11,4,22,49,88
Jovo Stanojevic,Alba Berlin,14,442,81,132,0.614,0,0,,81,132,0.614,0.614,32,48,0.667,32,51,83,20,14,6,42,41,194
JR Holden,CSKA Moscow,22,735,116,295,0.393,44,141,0.312,72,154,0.468,0.468,36,64,0.563,7,44,51,83,26,2,48,47,312
Juan Carlos Navarro,FC Barcelona,20,508,87,176,0.494,37,87,0.425,50,89,0.562,0.599,63,78,0.808,1,29,30,30,22,1,36,44,274
Jure Balazic,KK Krka,13,161,18,47,0.383,8,19,0.421,10,28,0.357,0.468,7,12,0.583,7,17,24,8,5,1,7,18,51
Jurica Golemac,Cibona Zagreb,20,516,71,150,0.473,14,39,0.359,57,111,0.514,0.52,51,79,0.646,31,68,99,51,14,7,48,74,207
Karim Souchu,Adecco ASVEL Villeurbanne,14,370,59,138,0.428,17,63,0.27,42,75,0.56,0.489,16,26,0.615,8,28,36,13,9,1,17,26,151
Kaya Peker,Efes Pilsen,18,353,62,113,0.549,0,0,,62,113,0.549,0.549,46,76,0.605,33,73,106,6,16,8,30,48,170
Kerem Gonlum,Fenerbahçe,19,355,40,74,0.541,0,3,0,40,71,0.563,0.541,23,40,0.575,45,49,94,5,15,5,20,57,103
Kerem Tunceri,Efes Pilsen,11,245,15,43,0.349,6,28,0.214,9,15,0.6,0.419,7,11,0.636,2,29,31,42,6,0,21,16,43
Koko Archibong,Elan Bearnais Pau-Orthez,13,148,17,36,0.472,4,9,0.444,13,27,0.481,0.528,4,8,0.5,8,17,25,2,5,3,10,22,42
Kornel David,TAU Ceramica,20,564,92,176,0.523,1,3,0.333,91,173,0.526,0.526,58,75,0.773,34,71,105,36,21,10,37,67,243
Kosta Perovic,Partizan,9,198,27,55,0.491,0,0,,27,55,0.491,0.491,8,15,0.533,17,19,36,9,4,6,10,30,62
Kostas Charissis,Olympiacos,1,2,1,2,0.5,0,0,,1,2,0.5,0.5,0,0,,1,0,1,0,0,0,0,2,2
Kostas Tsartsaris,Panathinaikos,20,436,71,128,0.555,6,21,0.286,65,107,0.607,0.578,29,41,0.707,32,72,104,17,14,7,21,71,177
Kyle Hill,AEK Athens,2,29,3,7,0.429,1,4,0.25,2,3,0.667,0.5,2,4,0.5,0,2,2,4,1,0,2,6,9
Larry Lewis,Unicaja Malaga,13,376,53,113,0.469,9,18,0.5,44,95,0.463,0.509,27,34,0.794,26,59,85,25,14,10,29,30,142
Laurent Foirest,Elan Bearnais Pau-Orthez,20,588,99,217,0.456,49,108,0.454,50,109,0.459,0.569,50,58,0.862,7,54,61,24,29,3,38,65,297
Louis Bullock,Unicaja Malaga,12,334,46,120,0.383,26,73,0.356,20,47,0.426,0.492,31,37,0.838,9,35,44,28,9,1,26,28,149
Lubos Barton,Lottomatica Roma,13,330,46,105,0.438,19,59,0.322,27,46,0.587,0.529,15,21,0.714,16,46,62,9,14,5,11,38,126
Luca Vitali,Montepaschi Siena,2,5,1,1,1,1,1,1,0,0,,1.5,0,0,,0,0,0,0,0,0,2,3,3
Luis Scola,TAU Ceramica,14,405,87,144,0.604,0,0,,87,144,0.604,0.604,39,51,0.765,32,53,85,33,19,6,40,56,213
Lynn Greer,Slask Wroclaw,14,503,114,250,0.456,34,82,0.415,80,168,0.476,0.524,89,99,0.899,8,36,44,77,21,1,49,47,351
Maceo Baston,Maccabi Tel Aviv,21,502,105,168,0.625,0,0,,105,168,0.625,0.625,48,81,0.593,47,123,170,19,27,30,52,72,258
Maciej Zielinski,Slask Wroclaw,13,277,26,66,0.394,4,28,0.143,22,38,0.579,0.424,11,21,0.524,4,26,30,11,10,2,18,34,67
Makan Dioumassi,Adecco ASVEL Villeurbanne,12,270,29,77,0.377,11,36,0.306,18,41,0.439,0.448,15,23,0.652,4,22,26,27,10,0,22,31,84
Manuchar Markoishvili,Benetton Treviso,6,43,3,10,0.3,3,7,0.429,0,3,0,0.45,2,2,1,1,3,4,3,1,0,3,6,11
Marc Gasol,FC Barcelona,9,38,4,10,0.4,0,0,,4,10,0.4,0.4,5,8,0.625,4,1,5,0,0,2,3,4,13
Marcelo Nicola,Benetton Treviso,18,329,46,96,0.479,27,72,0.375,19,24,0.792,0.62,21,30,0.7,4,43,47,35,19,1,23,49,140
Marco Belinelli,Skipper Fortitudo Bologna,16,202,17,40,0.425,9,23,0.391,8,17,0.471,0.538,5,6,0.833,8,1,9,5,5,0,7,18,48
Marcos Baltanas,Unicaja Malaga,3,18,2,3,0.667,1,1,1,1,2,0.5,0.833,0,0,,0,1,1,0,0,0,0,1,5
Marcus Brown,CSKA Moscow,21,718,128,251,0.51,34,89,0.382,94,162,0.58,0.578,103,117,0.88,19,29,48,89,29,2,46,55,393
Marcus Taylor,Adecco ASVEL Villeurbanne,5,66,10,36,0.278,2,8,0.25,8,28,0.286,0.306,2,3,0.667,6,2,8,8,1,0,3,10,24
Marijan Mance,Cibona Zagreb,19,317,42,82,0.512,7,21,0.333,35,61,0.574,0.555,13,19,0.684,10,32,42,18,10,0,10,28,104
Marino Bazdaric,KK Union Olimpija,20,622,86,213,0.404,40,116,0.345,46,97,0.474,0.498,51,58,0.879,10,80,90,35,30,0,37,57,263
Mario Bosnjak,KK Krka,1,20,4,6,0.667,0,1,0,4,5,0.8,0.667,0,1,0,2,0,2,0,1,0,2,2,8
Mario Dundovic,KK Krka,12,184,18,47,0.383,2,14,0.143,16,33,0.485,0.404,12,16,0.75,8,23,31,6,5,2,22,33,50
Marko Antonijevic,KK Krka,13,290,28,79,0.354,16,41,0.39,12,38,0.316,0.456,27,33,0.818,3,13,16,33,19,0,26,38,99
Marko Maravic,KK Union Olimpija,17,576,54,125,0.432,15,35,0.429,39,90,0.433,0.492,57,73,0.781,34,53,87,23,19,0,18,55,180
Marko Pesic,Alba Berlin,11,311,27,72,0.375,14,42,0.333,13,30,0.433,0.472,11,15,0.733,2,15,17,26,9,0,20,33,79
Marko Popovic,Cibona Zagreb,5,152,16,46,0.348,5,21,0.238,11,25,0.44,0.402,12,16,0.75,4,14,18,13,9,0,16,14,49
Marko Tusek,Lottomatica Roma,14,351,55,140,0.393,12,57,0.211,43,83,0.518,0.436,32,46,0.696,23,36,59,11,15,2,15,33,154
Marko Verginella,Alba Berlin,2,20,2,5,0.4,0,3,0,2,2,1,0.4,2,2,1,1,2,3,1,1,0,2,2,6
Martin Ides,Benetton Treviso,8,52,4,7,0.571,0,0,,4,7,0.571,0.571,2,4,0.5,5,8,13,1,1,2,5,12,10
Martin Mihajlovic,KK Krka,7,66,7,15,0.467,0,1,0,7,14,0.5,0.467,3,4,0.75,6,5,11,3,1,2,3,14,17
Marton Bader,KK Krka,13,385,44,98,0.449,3,14,0.214,41,84,0.488,0.464,28,42,0.667,36,63,99,14,11,11,14,43,119
Massimo Bulleri,Benetton Treviso,13,298,42,91,0.462,16,45,0.356,26,46,0.565,0.549,26,35,0.743,8,17,25,27,27,0,26,35,126
Mate Skelin,Elan Bearnais Pau-Orthez,20,466,57,111,0.514,0,0,,57,111,0.514,0.514,77,124,0.621,41,68,109,19,3,8,36,34,191
Matej Mamic,Cibona Zagreb,7,156,13,27,0.481,6,15,0.4,7,12,0.583,0.593,11,14,0.786,9,29,38,7,9,0,7,12,43
Matej Venta,KK Krka,1,13,1,1,1,0,0,,1,1,1,1,4,4,1,0,1,1,1,0,0,5,2,6
Matjaz Smodis,Skipper Fortitudo Bologna,21,563,86,157,0.548,21,52,0.404,65,105,0.619,0.615,43,50,0.86,36,62,98,15,30,11,36,71,236
Maurice Evans,Benetton Treviso,20,636,128,244,0.525,34,92,0.37,94,152,0.618,0.594,58,78,0.744,22,52,74,22,21,9,32,54,348
Maxime Renaud,Elan Bearnais Pau-Orthez,1,1,0,0,,0,0,,0,0,,,0,0,,0,0,0,0,0,0,0,0,0
Melvin Booker,Fenerbahçe,20,594,79,199,0.397,18,70,0.257,61,129,0.473,0.442,59,70,0.843,4,36,40,51,17,1,32,58,235
Michal Ignerski,Slask Wroclaw,13,237,19,51,0.373,7,22,0.318,12,29,0.414,0.441,3,4,0.75,8,29,37,6,7,0,10,26,48
Michalis Kakiouzis,Montepaschi Siena,21,443,77,146,0.527,25,58,0.431,52,88,0.591,0.613,23,39,0.59,25,59,84,9,25,1,18,41,202
Mike Batiste,Panathinaikos,16,270,47,107,0.439,9,27,0.333,38,80,0.475,0.481,23,29,0.793,14,37,51,6,12,3,17,28,126
Milan Tomic,Olympiacos,15,275,29,92,0.315,16,64,0.25,13,28,0.464,0.402,20,23,0.87,2,18,20,17,4,0,13,29,94
Milos Vujanic,Skipper Fortitudo Bologna,20,584,104,228,0.456,47,122,0.385,57,106,0.538,0.559,71,85,0.835,8,26,34,36,26,0,38,60,326
Mindaugas Budzinauskas,KK Krka,8,152,9,29,0.31,7,21,0.333,2,8,0.25,0.431,13,16,0.813,9,8,17,2,5,0,9,20,38
Mindaugas Timinskas,BC Zalgiris,20,504,53,113,0.469,14,41,0.341,39,72,0.542,0.531,40,56,0.714,34,69,103,42,22,6,35,69,160
Mindaugas Zukauskas,Montepaschi Siena,22,444,36,83,0.434,20,48,0.417,16,35,0.457,0.554,22,26,0.846,15,25,40,30,23,1,21,70,114
Mirko Kovac,Partizan,6,14,1,2,0.5,0,0,,1,2,0.5,0.5,2,2,1,0,1,1,1,0,0,1,2,4
Miroslav Beric,BC Zalgiris,9,213,30,60,0.5,13,31,0.419,17,29,0.586,0.608,15,24,0.625,1,11,12,15,3,0,21,21,88
Mirsad Turkcan,CSKA Moscow,20,512,70,158,0.443,12,49,0.245,58,109,0.532,0.481,47,69,0.681,70,139,209,21,15,6,27,35,199
Mithat Demirel,Alba Berlin,7,86,14,27,0.519,6,13,0.462,8,14,0.571,0.63,7,12,0.583,1,6,7,6,2,0,9,12,41
Mladjan Silobad,Partizan,6,26,0,3,0,0,2,0,0,1,0,0,0,0,,0,2,2,2,0,0,2,5,0
Moustapha Sonko,Unicaja Malaga,10,263,38,74,0.514,6,19,0.316,32,55,0.582,0.554,25,28,0.893,5,14,19,33,10,5,26,32,107
Muratcan Guler,Fenerbahçe,7,86,8,17,0.471,4,11,0.364,4,6,0.667,0.588,6,7,0.857,5,7,12,3,4,2,2,11,26
Nathan Erdmann,Elan Bearnais Pau-Orthez,12,282,31,85,0.365,16,44,0.364,15,41,0.366,0.459,11,13,0.846,6,26,32,22,18,2,18,36,89
Nenad Krstic,Partizan,9,223,45,75,0.6,0,1,0,45,74,0.608,0.6,31,43,0.721,9,17,26,5,2,9,11,30,121
Nikola Prkacin,Efes Pilsen,16,331,47,91,0.516,0,1,0,47,90,0.522,0.516,31,46,0.674,24,43,67,24,16,6,28,54,125
Nikola Vujcic,Maccabi Tel Aviv,21,733,137,250,0.548,7,31,0.226,130,219,0.594,0.562,72,90,0.8,39,106,145,62,18,17,46,66,353
Nikos Hatzis,AEK Athens,13,329,51,113,0.451,19,53,0.358,32,60,0.533,0.535,36,44,0.818,6,16,22,29,12,0,19,28,157
Nikos Hatzivrettas,Panathinaikos,20,602,79,172,0.459,25,73,0.342,54,99,0.545,0.532,58,74,0.784,6,51,57,25,11,2,22,58,241
Nikos Zisis,AEK Athens,14,371,44,110,0.4,14,44,0.318,30,66,0.455,0.464,19,30,0.633,10,26,36,29,11,0,8,40,121
Omer Onan,Efes Pilsen,11,90,11,25,0.44,7,14,0.5,4,11,0.364,0.58,6,12,0.5,2,4,6,1,2,0,9,12,35
Pablo Prigioni,TAU Ceramica,20,456,38,84,0.452,27,66,0.409,11,18,0.611,0.613,17,21,0.81,12,30,42,81,38,3,34,42,120
Panagiotis Liadelis,Olympiacos,20,586,100,191,0.524,13,35,0.371,87,156,0.558,0.558,126,142,0.887,5,37,42,25,23,0,30,42,339
Pantelis Papaioakim,AEK Athens,13,176,30,48,0.625,0,0,,30,48,0.625,0.625,12,20,0.6,15,25,40,8,4,0,5,41,72
Patricio Prato,Skipper Fortitudo Bologna,13,114,11,22,0.5,3,8,0.375,8,14,0.571,0.568,6,9,0.667,6,16,22,4,14,0,9,21,31
Patrick Femerling,FC Barcelona,20,446,48,82,0.585,0,0,,48,82,0.585,0.585,54,69,0.783,32,57,89,16,12,21,29,47,150
Paulius Jankunas,BC Zalgiris,16,218,30,57,0.526,0,1,0,30,56,0.536,0.526,14,22,0.636,22,24,46,10,8,4,8,30,74
Pawel Mroz,Slask Wroclaw,3,3,0,0,,0,0,,0,0,,,0,0,,0,0,0,0,0,0,0,0,0
Pedro Llompart,Pamesa Valencia,4,60,6,11,0.545,3,6,0.5,3,5,0.6,0.682,9,10,0.9,0,3,3,5,0,0,5,6,24
Pero Antic,AEK Athens,3,22,3,9,0.333,1,4,0.25,2,5,0.4,0.389,0,2,0,2,3,5,0,1,1,2,4,7
Pero Dujmovic,Fenerbahçe,1,8,0,0,,0,0,,0,0,,,0,0,,0,1,1,1,0,0,2,3,0
Pero Vasiljevic,Slask Wroclaw,9,88,9,20,0.45,0,0,,9,20,0.45,0.45,1,2,0.5,3,10,13,2,3,1,6,15,19
Petar Naumoski,Fenerbahçe,13,339,48,111,0.432,24,62,0.387,24,49,0.49,0.541,32,37,0.865,5,15,20,44,14,0,30,29,152
Predrag Materic,Partizan,13,94,4,6,0.667,4,6,0.667,0,0,,1,1,2,0.5,1,7,8,0,1,0,2,26,13
Quadre Michael Lollis,AEK Athens,12,383,56,100,0.56,7,20,0.35,49,80,0.613,0.595,32,58,0.552,36,81,117,17,10,5,28,41,151
Radoslaw Hyzy,Slask Wroclaw,13,157,12,26,0.462,0,0,,12,26,0.462,0.462,9,16,0.563,8,16,24,5,12,0,8,30,33
Rafael Huertas,Unicaja Malaga,1,1,0,1,0,0,0,,0,1,0,0,1,2,0.5,1,0,1,0,0,0,0,0,1
Rashard Griffith,Lottomatica Roma,14,356,43,75,0.573,0,1,0,43,74,0.581,0.573,18,39,0.462,43,58,101,17,12,12,25,50,104
Riccardo Pittis,Benetton Treviso,19,418,34,64,0.531,1,6,0.167,33,58,0.569,0.539,16,41,0.39,8,37,45,71,30,1,37,46,85
Rick Rickert,KK Krka,14,374,67,160,0.419,4,16,0.25,63,144,0.438,0.431,19,29,0.655,32,41,73,6,10,4,24,48,157
Robert Fultz,Skipper Fortitudo Bologna,3,14,0,0,,0,0,,0,0,,,3,4,0.75,0,0,0,0,1,0,2,5,3
Robert Gulyas,Adecco ASVEL Villeurbanne,9,267,59,97,0.608,2,5,0.4,57,92,0.62,0.619,20,27,0.741,19,38,57,9,5,13,11,26,140
Robert Kosciuk,Slask Wroclaw,9,55,4,11,0.364,2,5,0.4,2,6,0.333,0.455,0,0,,1,0,1,5,1,0,3,6,10
Robert Pack,Pamesa Valencia,5,122,14,35,0.4,4,8,0.5,10,27,0.37,0.457,25,30,0.833,1,8,9,11,10,0,14,15,57
Robert Skibniewski,Slask Wroclaw,8,38,2,9,0.222,1,2,0.5,1,7,0.143,0.278,0,0,,1,0,1,2,1,0,3,7,5
Roberto Chiacig,Montepaschi Siena,21,407,67,117,0.573,0,0,,67,117,0.573,0.573,50,91,0.549,42,68,110,11,29,11,40,51,184
Roberto Duenas,FC Barcelona,15,318,54,95,0.568,0,0,,54,95,0.568,0.568,15,22,0.682,37,61,98,14,5,7,25,40,123
Roberts Stelmahers,KK Union Olimpija,16,490,51,127,0.402,19,54,0.352,32,73,0.438,0.476,65,77,0.844,8,30,38,50,18,0,25,48,186
Rodrigo De La Fuente,FC Barcelona,20,484,49,104,0.471,14,39,0.359,35,65,0.538,0.538,11,13,0.846,12,53,65,25,17,3,17,42,123
Roger Grimau,FC Barcelona,9,163,20,35,0.571,3,15,0.2,17,20,0.85,0.614,17,18,0.944,5,14,19,10,13,1,13,17,60
Rolandas Alijevas,Adecco ASVEL Villeurbanne,6,47,8,19,0.421,1,5,0.2,7,14,0.5,0.447,2,7,0.286,4,1,5,5,4,0,2,2,19
Ruben Wolkowyski,Olympiacos,15,317,50,103,0.485,16,46,0.348,34,57,0.596,0.563,31,46,0.674,19,43,62,3,10,7,11,37,147
Ryan Randle,Slask Wroclaw,13,254,38,60,0.633,0,1,0,38,59,0.644,0.633,10,13,0.769,23,32,55,6,11,6,11,42,86
Sacha Giffa,Adecco ASVEL Villeurbanne,14,347,37,97,0.381,13,31,0.419,24,66,0.364,0.448,33,41,0.805,22,41,63,22,4,4,25,44,120
Samuele Podesta,Benetton Treviso,2,8,0,2,0,0,0,,0,2,0,0,0,0,,0,0,0,0,0,0,1,1,0
Sani Becirovic,KK Krka,2,40,3,11,0.273,0,1,0,3,10,0.3,0.273,2,2,1,1,3,4,8,1,0,5,3,8
Sarunas Jasikevicius,Maccabi Tel Aviv,21,624,95,199,0.477,47,105,0.448,48,94,0.511,0.595,98,106,0.925,10,24,34,100,15,0,52,59,335
Sascha Leutloff,Alba Berlin,3,18,2,3,0.667,0,0,,2,3,0.667,0.667,0,0,,0,0,0,0,0,0,0,4,4
Saso Ozbolt,KK Union Olimpija,15,251,25,59,0.424,13,34,0.382,12,25,0.48,0.534,19,25,0.76,3,13,16,15,10,0,16,26,82
Sasa Zagorac,KK Union Olimpija,1,3,0,0,,0,0,,0,0,,,0,0,,0,0,0,0,0,0,1,1,0
Scoonie Penn,Cibona Zagreb,13,403,55,117,0.47,14,33,0.424,41,84,0.488,0.53,56,65,0.862,5,32,37,44,30,0,30,30,180
Selim Saygin,Efes Pilsen,1,1,0,0,,0,0,,0,0,,,0,0,,0,0,0,0,0,0,0,0,0
Sergei Monia,CSKA Moscow,21,347,44,103,0.427,16,54,0.296,28,49,0.571,0.505,20,27,0.741,11,52,63,13,12,9,18,52,124
Sergey Panov,CSKA Moscow,22,257,28,63,0.444,9,26,0.346,19,37,0.514,0.516,13,14,0.929,21,45,66,16,18,4,10,51,78
Sergi Vidal,TAU Ceramica,20,510,48,112,0.429,10,37,0.27,38,75,0.507,0.473,38,49,0.776,14,57,71,33,25,1,15,43,144
Serkan Erdogan,Fenerbahçe,16,210,31,79,0.392,13,39,0.333,18,40,0.45,0.475,10,11,0.909,2,10,12,9,5,0,9,22,85
Shawnta Rogers,Adecco ASVEL Villeurbanne,7,217,28,80,0.35,11,34,0.324,17,46,0.37,0.419,9,12,0.75,5,16,21,28,12,0,8,20,76
Simon Petrov,KK Union Olimpija,20,420,55,124,0.444,26,63,0.413,29,61,0.475,0.548,35,37,0.946,5,15,20,36,4,1,17,56,171
Simonas Serapinas,BC Zalgiris,4,29,2,6,0.333,0,2,0,2,4,0.5,0.333,1,2,0.5,1,0,1,0,2,0,1,2,5
Slaven Rimac,Cibona Zagreb,16,437,80,157,0.51,29,55,0.527,51,102,0.5,0.602,46,57,0.807,8,40,48,33,7,1,36,36,235
Slavko Duscak,KK Krka,14,399,57,132,0.432,22,57,0.386,35,75,0.467,0.515,26,36,0.722,6,16,22,30,11,0,36,31,162
Smiljan Pavic,KK Union Olimpija,19,249,31,77,0.403,5,13,0.385,26,64,0.406,0.435,18,30,0.6,23,27,50,5,5,10,10,40,85
Sotiris Nikolaidis,AEK Athens,14,154,8,34,0.235,4,16,0.25,4,18,0.222,0.294,15,19,0.789,2,9,11,13,12,0,17,35,35
Spiros Magounis,AEK Athens,4,19,1,4,0.25,0,2,0,1,2,0.5,0.25,0,0,,0,0,0,1,0,1,1,3,2
Srdan Subotic,KK Krka,8,142,9,22,0.409,4,6,0.667,5,16,0.313,0.5,5,6,0.833,3,12,15,11,2,0,7,15,27
Stefan Ivanovic,TAU Ceramica,2,2,0,2,0,0,0,,0,2,0,0,0,0,,0,0,0,1,0,0,0,0,0
Stefano Garris,Alba Berlin,12,250,18,62,0.29,9,36,0.25,9,26,0.346,0.363,3,8,0.375,9,21,30,9,5,0,17,31,48
Stefano Mancinelli,Skipper Fortitudo Bologna,16,160,22,47,0.468,1,12,0.083,21,35,0.6,0.479,11,18,0.611,12,17,29,4,11,6,6,23,56
Stephane Risacher,Unicaja Malaga,9,206,26,66,0.394,6,23,0.261,20,43,0.465,0.439,6,9,0.667,7,20,27,7,4,2,15,23,64
Szymon Szewczyk,Alba Berlin,12,169,23,55,0.418,4,20,0.2,19,35,0.543,0.455,12,19,0.632,13,23,36,3,2,4,10,33,62
Tal Burstein,Maccabi Tel Aviv,21,557,63,135,0.467,13,41,0.317,50,94,0.532,0.515,34,53,0.642,14,50,64,46,26,1,25,58,173
Tanel Tein,Slask Wroclaw,14,419,38,92,0.413,17,54,0.315,21,38,0.553,0.505,21,24,0.875,12,29,41,11,17,2,8,39,114
Tanoka Beard,BC Zalgiris,20,520,110,196,0.561,0,5,0,110,191,0.576,0.561,71,102,0.696,73,79,152,13,22,16,39,62,291
Teoman Ozturk,Alba Berlin,11,74,9,16,0.563,1,1,1,8,15,0.533,0.594,6,8,0.75,3,8,11,0,2,0,3,15,25
Theodoros Papaloukas,CSKA Moscow,21,365,42,92,0.457,5,29,0.172,37,63,0.587,0.484,43,55,0.782,10,25,35,56,32,2,20,48,132
Tiago Splitter,TAU Ceramica,16,181,26,42,0.619,0,0,,26,42,0.619,0.619,12,19,0.632,11,28,39,5,6,5,15,33,64
Tomas Van Den Spiegel,Skipper Fortitudo Bologna,18,360,49,84,0.583,0,0,,49,84,0.583,0.583,36,65,0.554,38,66,104,3,27,15,21,66,134
Trajan Langdon,Efes Pilsen,20,662,96,208,0.462,36,92,0.391,60,116,0.517,0.548,57,66,0.864,7,53,60,32,30,4,37,57,285
Tutku Acik,Fenerbahçe,12,176,15,39,0.385,5,23,0.217,10,16,0.625,0.449,10,18,0.556,1,7,8,22,7,0,9,24,45
Tyus Edney,Benetton Treviso,18,542,97,212,0.458,17,51,0.333,80,161,0.497,0.498,63,75,0.84,5,30,35,82,23,2,39,33,274
Uros Slokar,Benetton Treviso,15,197,22,47,0.468,5,14,0.357,17,33,0.515,0.521,20,29,0.69,10,23,33,6,11,7,5,18,69
Uros Tripkovic,Partizan,1,2,0,1,0,0,0,,0,1,0,0,0,0,,0,2,2,0,0,0,0,1,0
Valentin Pastal,Efes Pilsen,1,1,0,0,,0,0,,0,0,,,0,0,,0,0,0,0,0,0,0,0,0
Vangelis Sklavos,Olympiacos,20,310,31,64,0.484,11,30,0.367,20,34,0.588,0.57,25,30,0.833,21,37,58,21,3,0,16,43,98
Veljko Mrsic,Fenerbahçe,6,75,3,13,0.231,0,3,0,3,10,0.3,0.231,12,14,0.857,3,6,9,9,1,0,2,7,18
Victor Alexander,CSKA Moscow,19,352,70,127,0.551,5,10,0.5,65,117,0.556,0.571,31,45,0.689,26,35,61,6,13,2,24,42,176
Victor Luengo,Pamesa Valencia,19,276,19,47,0.404,5,19,0.263,14,28,0.5,0.457,23,35,0.657,4,16,20,15,15,1,22,49,66
Victor Sada,FC Barcelona,4,37,5,9,0.556,0,1,0,5,8,0.625,0.556,2,2,1,0,6,6,3,2,0,3,3,12
Viktor Khryapa,CSKA Moscow,20,356,35,76,0.461,11,41,0.268,24,35,0.686,0.533,26,35,0.743,13,54,67,24,18,20,19,45,107
Vincenzo Esposito,Lottomatica Roma,1,26,5,10,0.5,2,4,0.5,3,6,0.5,0.6,2,2,1,0,2,2,0,1,0,5,4,14
Vladimir Boisa,KK Union Olimpija,19,530,61,149,0.409,22,63,0.349,39,86,0.453,0.483,33,53,0.623,21,36,57,18,12,5,25,77,177
Vladimir Petrovic,Alba Berlin,12,406,70,133,0.526,23,49,0.469,47,84,0.56,0.613,31,46,0.674,14,53,67,32,22,3,30,38,194
Vlado Ilievski,FC Barcelona,20,544,63,148,0.426,33,76,0.434,30,72,0.417,0.537,39,51,0.765,6,24,30,47,25,0,33,49,198
Vlado Scepanovic,Partizan,1,4,1,2,0.5,1,2,0.5,0,0,,0.75,1,2,0.5,0,1,1,0,1,0,0,1,4
Vrbica Stefanov,Montepaschi Siena,20,604,81,150,0.54,31,60,0.517,50,90,0.556,0.643,19,21,0.905,11,23,34,60,29,0,15,45,212
Vule Avdalovic,Partizan,14,323,28,73,0.384,15,39,0.385,13,34,0.382,0.486,34,42,0.81,4,15,19,23,13,2,23,53,105
Walter Herrmann,Unicaja Malaga,12,306,43,108,0.398,9,35,0.257,34,73,0.466,0.44,20,34,0.588,21,44,65,8,4,3,18,21,115
Ioannis Bourousis,AEK Athens,12,94,9,18,0.5,0,0,,9,18,0.5,0.5,3,7,0.429,9,17,26,3,4,4,2,23,21
Yoav Saffar,Maccabi Tel Aviv,3,1,0,0,,0,0,,0,0,,,0,0,,0,0,0,0,0,0,0,0,0
Yotam Halperin,Maccabi Tel Aviv,17,109,10,25,0.4,3,11,0.273,7,14,0.5,0.46,12,14,0.857,2,16,18,13,8,0,3,15,35