Player,Team,G,MP,FG,FGA,FG%,3P,3PA,3P%,2P,2PA,2P%,eFG%,FT,FTA,FT%,ORB,DRB,TRB,AST,STL,BLK,TOV,PF,PTS
Aaron Mitchell,CSKA Moscow,1,30,6,13,0.462,2,4,0.5,4,9,0.444,0.538,2,3,0.667,1,3,4,3,1,0,2,1,16
Adam Wojcik,Peristeri,14,410,87,162,0.537,14,40,0.35,73,122,0.598,0.58,69,87,0.793,15,31,46,19,17,10,28,39,257
Ademola Okulaja,FC Barcelona,20,546,100,191,0.524,17,49,0.347,83,142,0.585,0.568,47,83,0.566,48,77,125,29,32,9,30,47,264
Agi Ibeja,Peristeri,1,12,3,5,0.6,0,0,,3,5,0.6,0.6,0,2,0,0,1,1,0,0,0,0,3,6
Agron Xiarchos,Peristeri,7,59,5,11,0.455,0,0,,5,11,0.455,0.455,1,6,0.167,7,8,15,0,3,1,8,21,11
Alain Digbeu,FC Barcelona,19,388,51,101,0.505,18,46,0.391,33,55,0.6,0.594,32,41,0.78,12,38,50,25,20,7,26,44,152
Alan Tomidy,Benetton Treviso,7,54,12,15,0.8,1,1,1,11,14,0.786,0.833,1,2,0.5,3,4,7,1,1,1,3,6,26
Alberto Angulo,Real Madrid,18,328,53,96,0.552,8,20,0.4,45,76,0.592,0.594,23,27,0.852,7,27,34,19,17,0,36,27,137
Alberto Herreros,Real Madrid,17,439,64,136,0.471,36,83,0.434,28,53,0.528,0.603,50,56,0.893,11,33,44,21,23,2,25,27,214
Aleh Kojenets,Slask Wroclaw,4,64,6,15,0.4,0,0,,6,15,0.4,0.4,0,0,,2,11,13,1,0,0,5,10,12
Aleksandar Capin,KK Krka,12,112,10,20,0.5,1,9,0.111,9,11,0.818,0.525,2,4,0.5,3,3,6,9,3,0,7,16,23
Aleksandar Gajic,Partizan,3,13,2,2,1,0,0,,2,2,1,1,3,4,0.75,0,1,1,0,1,0,2,2,7
Aleksandar Glintic,Partizan,11,102,10,26,0.385,4,9,0.444,6,17,0.353,0.462,0,2,0,4,11,15,2,4,2,10,19,24
Aleksandar Okunskyy,KK Buducnost,5,99,13,25,0.52,0,0,,13,25,0.52,0.52,7,8,0.875,2,12,14,2,6,5,10,15,33
Aleksandar Smiljanic,KK Buducnost,10,185,26,60,0.433,7,30,0.233,19,30,0.633,0.492,24,27,0.889,3,7,10,13,13,0,17,29,83
Aleksander Djordjevic,Real Madrid,17,408,78,145,0.538,32,75,0.427,46,70,0.657,0.648,61,68,0.897,5,22,27,44,11,0,37,37,249
Aleksander Milosserdov,Slask Wroclaw,3,65,9,19,0.474,4,10,0.4,5,9,0.556,0.579,0,0,,0,6,6,6,4,0,6,7,22
Alessandro Abbio,Kinder Bologna,17,394,43,94,0.457,19,48,0.396,24,46,0.522,0.559,34,47,0.723,8,21,29,11,18,3,25,44,139
Alessandro Frosini,Kinder Bologna,21,424,54,96,0.563,0,0,,54,96,0.563,0.563,17,23,0.739,36,59,95,4,15,12,22,36,125
Alex Radojevic,KK Union Olimpija,7,71,9,15,0.6,0,0,,9,15,0.6,0.6,5,7,0.714,7,12,19,4,3,6,4,8,23
Alexander Kuehl,Peristeri,8,86,6,15,0.4,0,0,,6,15,0.4,0.4,6,10,0.6,5,7,12,1,1,1,12,10,18
Alexander Lokhmanchuk,Opel Skyliners,13,289,42,117,0.359,14,56,0.25,28,61,0.459,0.419,31,46,0.674,28,36,64,6,23,8,21,57,118
Alexander Miloserdov,Skipper Fortitudo Bologna,5,43,2,14,0.143,1,9,0.111,1,5,0.2,0.179,2,2,1,1,0,1,1,1,0,3,9,7
Alexandr Bashminov,Ural Great Perm,14,176,29,63,0.46,2,6,0.333,27,57,0.474,0.476,15,22,0.682,17,23,40,3,5,11,11,33,75
Alexandre Petrenko,CSKA Moscow,20,368,68,128,0.531,17,40,0.425,51,88,0.58,0.598,26,43,0.605,25,46,71,16,20,1,17,56,179
Alexei Savkov,CSKA Moscow,2,12,1,2,0.5,0,0,,1,2,0.5,0.5,1,2,0.5,0,0,0,0,0,0,0,1,3
Alexey Pegushin,Ural Great Perm,11,121,16,35,0.457,9,22,0.409,7,13,0.538,0.586,3,6,0.5,2,5,7,11,1,1,5,23,44
Alexey Savrasenko,Olympiacos,20,424,45,82,0.549,0,0,,45,82,0.549,0.549,25,61,0.41,51,74,125,10,10,22,29,61,115
Alexis Papadatos,Peristeri,11,162,24,38,0.632,12,20,0.6,12,18,0.667,0.789,3,4,0.75,6,14,20,12,7,0,14,26,63
Alfonso Alzamora,FC Barcelona,11,113,11,30,0.367,0,0,,11,30,0.367,0.367,11,18,0.611,8,12,20,1,3,0,7,16,33
Ali Traore,Adecco ASVEL Villeurbanne,1,1,0,0,,0,0,,0,0,,,0,0,,0,1,1,0,0,0,0,0,0
Allen Griffin,KK Union Olimpija,2,14,0,2,0,0,0,,0,2,0,0,1,2,0.5,0,0,0,0,1,0,0,1,1
Alper Yilmaz,Efes Pilsen,16,174,13,30,0.433,8,21,0.381,5,9,0.556,0.567,1,2,0.5,7,16,23,9,10,1,4,25,35
Alphonso Ford,Olympiacos,20,706,174,347,0.501,40,91,0.44,134,256,0.523,0.559,107,135,0.793,27,68,95,64,24,11,68,61,495
Amara Sy,Adecco ASVEL Villeurbanne,13,207,22,53,0.415,1,7,0.143,21,46,0.457,0.425,7,13,0.538,12,16,28,8,7,8,12,28,52
Anderson Varejao,FC Barcelona,9,122,16,30,0.533,1,1,1,15,29,0.517,0.55,9,15,0.6,17,19,36,2,10,4,11,27,42
Andrea Meneghin,Skipper Fortitudo Bologna,19,523,65,160,0.406,32,90,0.356,33,70,0.471,0.506,37,47,0.787,7,33,40,48,34,3,34,74,199
Andrea Pecile,Scavolini Pesaro,14,230,20,67,0.299,7,33,0.212,13,34,0.382,0.351,38,58,0.655,10,12,22,15,11,0,22,33,85
Andrei Fetisov,Slask Wroclaw,8,217,29,67,0.433,15,34,0.441,14,33,0.424,0.545,26,31,0.839,8,36,44,14,11,15,16,28,99
Andrei Fetisov,CSKA Moscow,2,15,1,4,0.25,0,1,0,1,3,0.333,0.25,0,0,,1,0,1,1,1,1,1,3,2
Andres Nocioni,TAU Ceramica,20,410,65,128,0.508,16,38,0.421,49,90,0.544,0.57,35,45,0.778,14,62,76,17,26,12,47,48,181
Andrew Betts,AEK Athens,19,490,57,119,0.479,0,0,,57,119,0.479,0.479,73,104,0.702,46,74,120,11,4,9,47,63,187
Andrey Sheyko,Ural Great Perm,7,67,3,9,0.333,0,2,0,3,7,0.429,0.333,1,3,0.333,5,3,8,5,2,1,11,9,7
Andrius Giedraitis,BC Oostende,14,384,56,107,0.523,18,34,0.529,38,73,0.521,0.607,61,69,0.884,12,37,49,23,16,3,18,36,191
Andrius Jurkunas,BC Zalgiris,5,109,12,18,0.667,8,14,0.571,4,4,1,0.889,1,4,0.25,3,6,9,4,2,3,11,19,33
Andrzej Adamek,Slask Wroclaw,7,81,2,15,0.133,1,10,0.1,1,5,0.2,0.167,0,2,0,0,3,3,8,7,0,6,9,5
Anthony Bowie,Ural Great Perm,17,466,47,114,0.412,17,48,0.354,30,66,0.455,0.487,31,43,0.721,12,40,52,46,13,2,35,40,142
Anthony Goldwire,Skipper Fortitudo Bologna,11,257,28,74,0.378,9,31,0.29,19,43,0.442,0.439,11,20,0.55,7,12,19,16,14,0,17,31,76
Anthony Parker,Maccabi Tel Aviv,20,692,120,238,0.504,20,59,0.339,100,179,0.559,0.546,69,95,0.726,20,84,104,33,31,6,35,52,329
Antoine Rigaudeau,Kinder Bologna,21,561,61,133,0.459,20,56,0.357,41,77,0.532,0.534,34,38,0.895,5,40,45,30,26,3,30,60,176
Antonio Granger,Kinder Bologna,2,26,4,6,0.667,2,4,0.5,2,2,1,0.833,0,2,0,2,1,3,0,0,0,1,0,10
Antwain Smith,KK Krka,1,4,0,0,,0,0,,0,0,,,0,2,0,0,0,0,0,0,0,0,1,0
Arda Vekiloglu,Efes Pilsen,16,186,19,63,0.302,4,22,0.182,15,41,0.366,0.333,13,20,0.65,13,18,31,2,8,2,4,24,55
Arijan Komazec,AEK Athens,8,172,28,52,0.538,7,18,0.389,21,34,0.618,0.606,13,14,0.929,6,11,17,7,5,0,10,27,76
Arriel McDonald,Maccabi Tel Aviv,20,636,88,196,0.449,20,73,0.274,68,123,0.553,0.5,67,82,0.817,9,39,48,76,36,2,26,57,263
Arsene Ade Mensah,Adecco ASVEL Villeurbanne,5,51,5,13,0.385,0,3,0,5,10,0.5,0.385,0,0,,3,1,4,11,4,0,6,9,10
Artur Drozdov,Elan Bearnais Pau-Orthez,6,54,8,14,0.571,2,6,0.333,6,8,0.75,0.643,4,8,0.5,2,6,8,4,0,0,5,3,22
Arturas Karnisovas,FC Barcelona,20,482,73,170,0.429,30,86,0.349,43,84,0.512,0.518,30,38,0.789,18,56,74,27,27,3,29,42,206
Arturas Masiulis,BC Zalgiris,9,84,7,19,0.368,0,0,,7,19,0.368,0.368,8,10,0.8,7,15,22,2,4,5,5,17,22
Asim Pars,Fenerbahçe,18,306,51,110,0.464,0,1,0,51,109,0.468,0.464,34,57,0.596,27,25,52,17,10,5,28,54,136
Balsa Radunovic,KK Buducnost,11,153,15,40,0.375,3,15,0.2,12,25,0.48,0.413,9,12,0.75,6,17,23,12,9,2,12,28,42
Barisa Krasic,Cibona Zagreb,5,86,10,26,0.385,4,13,0.308,6,13,0.462,0.462,18,19,0.947,2,8,10,2,2,4,2,23,42
Bennett Davison,KK Krka,14,364,64,134,0.478,2,6,0.333,62,128,0.484,0.485,25,43,0.581,33,52,85,12,13,9,32,54,155
Beno Udrih,KK Union Olimpija,19,519,75,157,0.478,19,56,0.339,56,101,0.554,0.538,36,47,0.766,13,34,47,50,34,2,38,47,205
Berni Rodriguez,Unicaja Malaga,14,319,33,82,0.402,12,40,0.3,21,42,0.5,0.476,21,30,0.7,6,19,25,31,12,0,20,31,99
Blagota Sekulic,KK Buducnost,10,129,20,30,0.667,1,5,0.2,19,25,0.76,0.683,8,12,0.667,13,11,24,0,6,1,6,11,49
Bob Menama,BC Oostende,7,53,1,3,0.333,0,1,0,1,2,0.5,0.333,2,2,1,2,11,13,0,0,0,3,13,4
Bojan Bakic,KK Buducnost,8,94,5,17,0.294,2,6,0.333,3,11,0.273,0.353,12,13,0.923,4,4,8,3,2,0,5,16,24
Boris Diaw,Elan Bearnais Pau-Orthez,14,305,38,75,0.507,6,16,0.375,32,59,0.542,0.547,11,21,0.524,11,29,40,24,5,5,11,32,93
Boris Dzidic,Cibona Zagreb,8,91,6,27,0.222,4,20,0.2,2,7,0.286,0.296,7,10,0.7,2,15,17,3,2,1,3,15,23
Boris Gnjidic,KK Krka,14,398,57,113,0.504,24,51,0.471,33,62,0.532,0.611,24,29,0.828,28,28,56,13,14,4,24,55,162
Bostjan Nachbar,Benetton Treviso,21,533,94,198,0.475,23,69,0.333,71,129,0.55,0.533,49,63,0.778,15,63,78,30,21,4,34,64,260
Bradley Traina,Scavolini Pesaro,19,367,44,112,0.393,21,57,0.368,23,55,0.418,0.487,6,11,0.545,13,29,42,10,14,1,29,43,115
Branimir Longin,Cibona Zagreb,10,126,13,34,0.382,6,18,0.333,7,16,0.438,0.471,5,13,0.385,7,13,20,5,3,0,4,21,37
Brett Eppehimer,London Towers,12,391,53,159,0.333,24,82,0.293,29,77,0.377,0.409,41,49,0.837,5,14,19,18,12,0,42,21,171
Bud Eley,Fenerbahçe,13,250,46,85,0.541,0,0,,46,85,0.541,0.541,32,51,0.627,41,45,86,3,14,8,29,45,124
Byron Dinkins,Peristeri,14,412,69,141,0.489,20,58,0.345,49,83,0.59,0.56,24,32,0.75,5,27,32,38,15,0,37,34,182
Calvin Bowman,Cibona Zagreb,14,328,49,103,0.476,0,2,0,49,101,0.485,0.476,24,46,0.522,22,41,63,6,4,12,22,40,122
Carlo Ferri,Kinder Bologna,3,4,0,2,0,0,0,,0,2,0,0,0,0,,0,1,1,0,0,0,0,0,0
Carlos Arroyo,TAU Ceramica,3,45,11,20,0.55,1,5,0.2,10,15,0.667,0.575,6,6,1,1,2,3,7,1,0,3,5,29
Carlos Cabezas,Unicaja Malaga,14,267,27,68,0.397,9,26,0.346,18,42,0.429,0.463,21,29,0.724,4,16,20,19,14,2,13,30,84
Chad Austin,Opel Skyliners,14,498,77,219,0.352,22,75,0.293,55,144,0.382,0.402,37,44,0.841,19,39,58,20,16,0,36,37,213
Charles Byrd,TAU Ceramica,2,20,5,7,0.714,2,2,1,3,5,0.6,0.857,0,0,,0,0,0,0,1,0,1,3,12
Charlie Bell,Benetton Treviso,3,75,12,31,0.387,5,15,0.333,7,16,0.438,0.468,6,7,0.857,3,6,9,3,1,1,6,8,35
Chris Carr,AEK Athens,9,158,25,69,0.362,11,27,0.407,14,42,0.333,0.442,7,11,0.636,5,9,14,16,6,0,16,24,68
Chris Corchiani,TAU Ceramica,17,325,27,65,0.415,12,38,0.316,15,27,0.556,0.508,40,50,0.8,8,16,24,36,22,0,22,40,106
Christophe Beghin,BC Oostende,14,398,56,124,0.452,0,3,0,56,121,0.463,0.452,32,49,0.653,34,42,76,7,13,8,23,45,144
Christos Harissis,TAU Ceramica,1,10,2,5,0.4,0,2,0,2,3,0.667,0.4,2,2,1,0,0,0,0,1,0,1,2,6
Christos Tapoutos,AEK Athens,7,62,9,13,0.692,1,4,0.25,8,9,0.889,0.731,3,5,0.6,3,8,11,0,1,0,3,5,22
Chuck Kornegay,Unicaja Malaga,14,272,35,58,0.603,0,1,0,35,57,0.614,0.603,16,25,0.64,26,42,68,8,6,14,22,33,86
Claudio Pilutti,Skipper Fortitudo Bologna,13,207,24,42,0.571,16,24,0.667,8,18,0.444,0.762,3,7,0.429,5,16,21,11,5,1,8,29,67
Corey Albano,Panathinaikos,15,231,37,65,0.569,4,9,0.444,33,56,0.589,0.6,20,27,0.741,13,26,39,8,9,0,18,42,98
Cristian Akrivos,Kinder Bologna,1,2,2,4,0.5,1,2,0.5,1,2,0.5,0.625,0,0,,0,0,0,0,0,0,0,1,5
Curtis McCants,CSKA Moscow,19,540,96,194,0.495,21,54,0.389,75,140,0.536,0.549,50,62,0.806,4,25,29,65,17,1,41,42,263
Dainius Adomaitis,Slask Wroclaw,14,426,48,95,0.505,19,40,0.475,29,55,0.527,0.605,36,52,0.692,13,45,58,20,5,3,26,49,151
Dainius Salenga,BC Zalgiris,14,426,56,125,0.448,18,52,0.346,38,73,0.521,0.52,34,42,0.81,17,20,37,27,20,6,27,23,164
Damir Mulaomerovic,Panathinaikos,15,443,66,144,0.458,23,53,0.434,43,91,0.473,0.538,47,63,0.746,5,24,29,38,21,0,41,51,202
Danya Abrams,Unicaja Malaga,10,241,35,87,0.402,3,18,0.167,32,69,0.464,0.42,38,58,0.655,13,43,56,13,8,7,27,40,111
Darko Krunic,Cibona Zagreb,4,49,9,18,0.5,6,9,0.667,3,9,0.333,0.667,4,4,1,5,2,7,5,2,0,1,9,28
Darren Engellant,Spirou Charleroi,10,137,8,15,0.533,0,0,,8,15,0.533,0.533,0,2,0,12,29,41,4,5,4,12,18,16
Darren Phillip,Unicaja Malaga,14,231,33,61,0.541,0,1,0,33,60,0.55,0.541,20,27,0.741,27,27,54,5,9,0,13,32,86
Darryl Middleton,Panathinaikos,22,466,74,110,0.673,0,1,0,74,109,0.679,0.673,59,90,0.656,30,40,70,13,11,4,36,74,207
David Andersen,Kinder Bologna,22,473,72,149,0.483,0,0,,72,149,0.483,0.483,47,70,0.671,29,66,95,9,19,4,26,51,191
David Brkic,Kinder Bologna,10,66,7,14,0.5,3,6,0.5,4,8,0.5,0.607,5,6,0.833,5,7,12,1,0,2,3,8,22
David Desy,Spirou Charleroi,10,203,22,46,0.478,5,22,0.227,17,24,0.708,0.533,7,9,0.778,1,11,12,12,3,0,14,23,56
David Frigout,Adecco ASVEL Villeurbanne,13,283,47,80,0.588,0,2,0,47,78,0.603,0.588,14,23,0.609,19,31,50,7,9,10,15,41,108
Davide Bonora,Kinder Bologna,8,81,4,13,0.308,0,5,0,4,8,0.5,0.308,1,2,0.5,1,4,5,3,2,0,1,10,9
Davor Kus,Cibona Zagreb,10,193,17,43,0.395,6,24,0.25,11,19,0.579,0.465,9,14,0.643,4,5,9,24,8,0,8,18,49
Davor Marcelic,Skipper Fortitudo Bologna,9,248,34,68,0.5,18,44,0.409,16,24,0.667,0.632,7,12,0.583,19,27,46,9,6,0,8,21,93
Davor Marcelic,KK Zadar,11,430,70,171,0.409,26,86,0.302,44,85,0.518,0.485,32,41,0.78,12,23,35,20,25,0,24,21,198
Davor Pejcinovic,KK Buducnost,6,74,8,14,0.571,0,0,,8,14,0.571,0.571,6,13,0.462,6,9,15,2,0,5,3,18,22
Davor Tomic,London Towers,8,48,1,12,0.083,0,2,0,1,10,0.1,0.083,4,7,0.571,7,5,12,2,3,0,6,1,6
Dejan Bodiroga,Panathinaikos,22,711,148,251,0.59,16,41,0.39,132,210,0.629,0.622,129,162,0.796,20,94,114,42,21,1,42,63,441
Dejan Koturovic,Alba Berlin,8,217,36,77,0.468,0,0,,36,77,0.468,0.468,31,45,0.689,15,42,57,6,5,9,25,28,103
Dejan Milojevic,KK Buducnost,8,187,30,55,0.545,7,17,0.412,23,38,0.605,0.609,9,24,0.375,26,25,51,3,13,2,15,28,76
Dejan Radonjic,KK Buducnost,12,190,26,57,0.456,18,44,0.409,8,13,0.615,0.614,9,14,0.643,2,7,9,17,5,1,8,28,79
Dejan Tomasevic,TAU Ceramica,20,568,104,164,0.634,0,0,,104,164,0.634,0.634,72,113,0.637,59,93,152,41,17,10,36,54,280
Demarco Johnson,Scavolini Pesaro,6,165,36,68,0.529,1,2,0.5,35,66,0.53,0.537,19,28,0.679,10,28,38,4,10,0,18,22,92
Denapoka Guedegbe,Adecco ASVEL Villeurbanne,1,1,0,0,,0,0,,0,0,,,0,0,,0,0,0,0,0,0,1,1,0
Denis Marconato,Benetton Treviso,20,388,53,87,0.609,3,5,0.6,50,82,0.61,0.626,30,43,0.698,36,77,113,11,17,14,21,61,139
Derrick Lewis,Elan Bearnais Pau-Orthez,12,156,14,40,0.35,4,15,0.267,10,25,0.4,0.4,8,11,0.727,5,20,25,8,11,4,5,28,40
Derrick Phelps,Alba Berlin,13,423,61,143,0.427,16,47,0.34,45,96,0.469,0.483,47,56,0.839,9,48,57,53,29,2,39,35,185
Derrick Sharp,Maccabi Tel Aviv,20,408,47,106,0.443,21,55,0.382,26,51,0.51,0.542,20,21,0.952,7,15,22,14,18,0,15,58,135
Didier Gadou,Elan Bearnais Pau-Orthez,12,126,7,17,0.412,4,11,0.364,3,6,0.5,0.529,7,7,1,3,12,15,13,5,1,11,23,25
Dimitrios Papanikolaou,Olympiacos,18,221,27,60,0.45,3,17,0.176,24,43,0.558,0.475,26,34,0.765,10,27,37,14,4,2,9,30,83
Dimos Dikoudis,AEK Athens,19,568,113,195,0.579,11,28,0.393,102,167,0.611,0.608,73,114,0.64,51,83,134,13,15,9,38,71,310
Dino Radja,Cibona Zagreb,3,82,16,39,0.41,0,0,,16,39,0.41,0.41,9,10,0.9,4,24,28,5,2,0,1,7,41
Djuro Ostojic,Partizan,12,218,24,40,0.6,0,0,,24,40,0.6,0.6,18,25,0.72,23,27,50,2,4,4,18,43,66
Dmitry Domani,CSKA Moscow,19,452,33,72,0.458,4,20,0.2,29,52,0.558,0.486,43,68,0.632,19,34,53,30,18,3,26,59,113
Dominik Hennen,Opel Skyliners,2,4,0,0,,0,0,,0,0,,,1,2,0.5,1,0,1,0,0,0,1,0,1
Dominik Tomczyk,Slask Wroclaw,11,253,34,76,0.447,14,33,0.424,20,43,0.465,0.539,24,29,0.828,17,34,51,5,5,8,16,33,106
Donatas Slanina,BC Zalgiris,14,428,78,199,0.392,31,96,0.323,47,103,0.456,0.47,45,51,0.882,11,27,38,24,14,0,28,37,232
Doug Overton,FC Barcelona,2,36,6,14,0.429,4,9,0.444,2,5,0.4,0.571,1,1,1,0,3,3,3,0,0,2,4,17
Dragan Ceranic,KK Buducnost,6,88,8,19,0.421,0,1,0,8,18,0.444,0.421,16,23,0.696,7,17,24,0,2,1,6,20,32
Dragan Lukovski,Elan Bearnais Pau-Orthez,14,351,58,123,0.472,12,36,0.333,46,87,0.529,0.52,76,89,0.854,8,21,29,50,15,0,32,29,204
Dragan Tarlac,Real Madrid,15,345,47,81,0.58,0,0,,47,81,0.58,0.58,46,63,0.73,17,67,84,15,6,10,34,44,140
Dragan Vukcevic,KK Buducnost,14,206,21,64,0.328,7,30,0.233,14,34,0.412,0.383,20,29,0.69,2,9,11,8,4,1,13,26,69
Dragisa Drobnjak,KK Krka,14,262,28,62,0.452,6,22,0.273,22,40,0.55,0.5,8,10,0.8,4,28,32,12,10,7,13,36,70
Dusan Bocevski,KK Zadar,3,53,10,15,0.667,2,4,0.5,8,11,0.727,0.733,2,4,0.5,4,5,9,3,3,0,1,9,24
Dusan Jelic,Olympiacos,5,32,5,9,0.556,0,0,,5,9,0.556,0.556,5,5,1,3,10,13,1,0,0,2,6,15
Dusan Vukcevic,Real Madrid,19,428,72,143,0.503,32,66,0.485,40,77,0.519,0.615,35,52,0.673,7,40,47,24,17,2,24,39,211
Ed Cota,BC Oostende,8,256,42,92,0.457,9,32,0.281,33,60,0.55,0.505,24,37,0.649,8,15,23,41,12,1,24,20,117
Eduardo Hernandez,TAU Ceramica,1,2,0,1,0,0,0,,0,1,0,0,0,0,,1,0,1,1,0,0,0,1,0
Eduardo Hernandez Sonseca,Real Madrid,10,163,25,41,0.61,1,3,0.333,24,38,0.632,0.622,14,17,0.824,9,31,40,1,4,13,9,23,65
Efthimios Rentzias,FC Barcelona,19,346,72,135,0.533,13,41,0.317,59,94,0.628,0.581,16,25,0.64,24,47,71,7,16,9,22,47,173
Elmer Bennett,TAU Ceramica,15,455,61,147,0.415,27,79,0.342,34,68,0.5,0.507,34,42,0.81,10,27,37,79,21,0,40,39,183
Emilio Kovacic,Skipper Fortitudo Bologna,13,248,42,77,0.545,1,1,1,41,76,0.539,0.552,14,21,0.667,19,40,59,10,11,8,13,26,99
Emre Ekim,Olympiacos,1,3,0,0,,0,0,,0,0,,,0,0,,0,1,1,0,1,0,1,1,0
Ender Arslan,Efes Pilsen,6,110,8,24,0.333,4,12,0.333,4,12,0.333,0.417,7,13,0.538,0,7,7,7,6,0,3,14,27
Enver Ekmen,Efes Pilsen,1,1,0,0,,0,0,,0,0,,,0,0,,0,0,0,0,0,0,0,0,0
Eric Elliot,BC Oostende,5,109,8,27,0.296,4,12,0.333,4,15,0.267,0.37,0,0,,0,6,6,8,1,0,9,5,20
Eric Struelens,Real Madrid,16,365,44,83,0.53,0,0,,44,83,0.53,0.53,34,44,0.773,30,60,90,12,11,23,31,43,122
Eyinmisan Nikagbatse,Olympiacos,11,39,3,6,0.5,2,3,0.667,1,3,0.333,0.667,11,12,0.917,1,3,4,6,3,0,3,7,19
Fabio Zanelli,Scavolini Pesaro,3,38,2,6,0.333,0,1,0,2,5,0.4,0.333,1,1,1,1,2,3,2,1,0,3,8,5
Fabricio Oberto,TAU Ceramica,19,486,86,150,0.573,0,1,0,86,149,0.577,0.573,19,49,0.388,45,76,121,23,24,8,44,78,191
Florent Pietrus,Elan Bearnais Pau-Orthez,13,300,31,65,0.477,1,4,0.25,30,61,0.492,0.485,40,48,0.833,22,59,81,10,18,6,34,41,103
Fragiskos Alvertis,Panathinaikos,22,572,68,147,0.463,25,67,0.373,43,80,0.538,0.548,64,79,0.81,10,56,66,15,19,4,20,73,225
Fran Vazquez,Unicaja Malaga,1,25,2,9,0.222,1,8,0.125,1,1,1,0.278,0,0,,1,1,2,2,4,0,0,1,5
Francesco Basei,Benetton Treviso,1,2,0,0,,0,0,,0,0,,,1,2,0.5,0,2,2,1,0,0,0,0,1
Fred Vinson,Slask Wroclaw,6,122,15,39,0.385,10,23,0.435,5,16,0.313,0.513,3,4,0.75,4,12,16,3,7,1,10,13,43
Frederic Fauthoux,Elan Bearnais Pau-Orthez,13,194,22,59,0.373,17,49,0.347,5,10,0.5,0.517,22,25,0.88,2,9,11,15,2,1,19,19,83
Frederic Weis,Unicaja Malaga,14,307,30,54,0.556,0,0,,30,54,0.556,0.556,21,47,0.447,31,43,74,12,11,16,19,47,81
Gabriel Fernandez,TAU Ceramica,6,64,9,16,0.563,6,10,0.6,3,6,0.5,0.75,3,6,0.5,2,5,7,1,1,0,0,11,27
George Zidek,Alba Berlin,4,75,11,22,0.5,6,7,0.857,5,15,0.333,0.636,5,10,0.5,6,6,12,1,0,0,3,12,33
Georgios Kalaitzis,Panathinaikos,10,167,15,39,0.385,4,16,0.25,11,23,0.478,0.436,2,2,1,0,8,8,18,7,0,12,27,36
Gerrit Major,BC Oostende,14,239,15,38,0.395,3,8,0.375,12,30,0.4,0.434,10,17,0.588,12,10,22,15,9,1,22,49,43
Giacomo Galanda,Skipper Fortitudo Bologna,16,277,35,74,0.473,14,38,0.368,21,36,0.583,0.568,16,23,0.696,17,28,45,9,10,9,20,50,100
Gianluca Basile,Skipper Fortitudo Bologna,17,551,65,147,0.442,40,93,0.43,25,54,0.463,0.578,30,41,0.732,10,28,38,55,27,7,28,38,200
Giannis Giannoulis,Panathinaikos,13,222,33,41,0.805,0,1,0,33,40,0.825,0.805,29,49,0.592,18,39,57,7,13,5,23,30,95
Giannis Mitropoulos,Peristeri,8,74,6,15,0.4,4,11,0.364,2,4,0.5,0.533,0,0,,1,7,8,2,3,0,7,12,16
Giannis Sioutis,Panathinaikos,8,103,2,16,0.125,1,9,0.111,1,7,0.143,0.156,5,6,0.833,3,7,10,4,1,0,5,14,10
Giannis Stamopoulos,Peristeri,1,5,1,2,0.5,1,1,1,0,1,0,0.75,0,0,,0,0,0,0,1,0,0,2,3
Giedrius Gustas,BC Zalgiris,7,69,4,20,0.2,0,7,0,4,13,0.308,0.2,2,4,0.5,2,6,8,7,3,0,5,10,10
Gintaras Einikis,Slask Wroclaw,9,199,33,82,0.402,2,11,0.182,31,71,0.437,0.415,13,17,0.765,12,28,40,7,5,5,9,25,81
Giorgos Balogiannis,Panathinaikos,3,13,2,3,0.667,2,3,0.667,0,0,,1,0,0,,0,2,2,0,0,1,1,2,6
Giorgos Pantazopoulos,Peristeri,14,196,15,48,0.313,12,38,0.316,3,10,0.3,0.438,10,12,0.833,0,10,10,12,7,0,18,22,52
Giorgos Tsiaras,AEK Athens,5,20,2,3,0.667,0,0,,2,3,0.667,0.667,3,7,0.429,1,4,5,1,0,0,4,6,7
Goran Cakic,KK Buducnost,4,54,8,13,0.615,2,4,0.5,6,9,0.667,0.692,3,4,0.75,2,7,9,0,3,0,3,13,21
Gordan Firic,Adecco ASVEL Villeurbanne,1,9,0,0,,0,0,,0,0,,,0,0,,0,1,1,2,1,0,0,2,0
Gordan Giriček,CSKA Moscow,18,592,149,282,0.528,31,83,0.373,118,199,0.593,0.583,84,104,0.808,10,46,56,29,19,1,41,40,413
Gregor Fucka,Skipper Fortitudo Bologna,20,638,137,285,0.481,18,49,0.367,119,236,0.504,0.512,89,139,0.64,63,101,164,26,38,10,48,64,381
Grygorii Khizhniak,BC Zalgiris,14,449,65,128,0.508,1,3,0.333,64,125,0.512,0.512,71,80,0.888,28,85,113,20,13,45,34,51,202
Gur Shelef,Maccabi Tel Aviv,19,296,31,64,0.484,5,8,0.625,26,56,0.464,0.523,43,60,0.717,13,30,43,18,17,1,18,47,110
Hakki Erdenay,Fenerbahçe,19,462,89,200,0.445,36,94,0.383,53,106,0.5,0.535,47,58,0.81,10,23,33,36,14,0,30,29,261
Haluk Yildirim,Fenerbahçe,18,454,52,122,0.426,23,72,0.319,29,50,0.58,0.52,22,29,0.759,10,22,32,50,13,2,30,41,149
Haris Mujezinovic,KK Union Olimpija,20,470,85,155,0.548,5,15,0.333,80,140,0.571,0.565,49,70,0.7,38,61,99,17,31,6,41,72,224
Harold Mrazek,Adecco ASVEL Villeurbanne,10,192,23,47,0.489,16,33,0.485,7,14,0.5,0.66,15,15,1,3,15,18,15,14,0,16,31,77
Henrik Rodl,Alba Berlin,10,239,21,41,0.512,4,13,0.308,17,28,0.607,0.561,18,23,0.783,8,14,22,18,10,3,15,24,64
Herve Toure,Adecco ASVEL Villeurbanne,1,1,0,0,,0,0,,0,0,,,0,0,,0,0,0,0,0,0,0,0,0
Hrvoje Perincic,KK Zadar,14,332,35,92,0.38,14,42,0.333,21,50,0.42,0.457,14,19,0.737,7,36,43,11,14,0,11,40,98
Hugo Sconochini,TAU Ceramica,12,196,24,54,0.444,5,20,0.25,19,34,0.559,0.491,12,19,0.632,8,22,30,13,7,2,19,27,65
Huseyin Besok,Maccabi Tel Aviv,18,230,38,76,0.5,2,2,1,36,74,0.486,0.513,27,36,0.75,21,45,66,9,5,7,16,39,105
Ibrahim Diarra,Opel Skyliners,14,234,3,18,0.167,0,1,0,3,17,0.176,0.167,1,4,0.25,7,21,28,12,7,0,14,27,7
Ibrahim Kutluay,Panathinaikos,18,463,56,141,0.397,25,74,0.338,31,67,0.463,0.486,55,79,0.696,7,26,33,17,18,0,25,53,192
Ignacio De Miguel,Olympiacos,20,314,45,80,0.563,0,0,,45,80,0.563,0.563,41,52,0.788,25,51,76,7,12,2,25,73,131
Ignacio Rodriguez,FC Barcelona,19,363,32,72,0.444,11,28,0.393,21,44,0.477,0.521,34,43,0.791,12,42,54,54,22,0,20,36,109
Igor Ivaskovic,KK Krka,1,3,0,0,,0,0,,0,0,,,2,2,1,0,0,0,0,0,0,0,0,2
Igor Rakocevic,KK Buducnost,14,414,86,179,0.48,19,55,0.345,67,124,0.54,0.534,57,87,0.655,6,17,23,29,18,0,42,25,248
Iker Iturbe,Real Madrid,16,251,34,63,0.54,17,34,0.5,17,29,0.586,0.675,15,19,0.789,14,32,46,16,10,3,21,39,100
Ingmar Janke,Opel Skyliners,1,2,0,0,,0,0,,0,0,,,0,0,,0,0,0,0,0,0,0,0,0
Inyang Ime Oduok,KK Zadar,13,371,42,97,0.433,0,0,,42,97,0.433,0.433,42,70,0.6,29,51,80,5,17,10,34,37,126
Isaac Austin,Fenerbahçe,1,24,2,7,0.286,2,6,0.333,0,1,0,0.429,1,2,0.5,0,3,3,7,0,1,5,3,7
Ivan Grgat,KK Zadar,14,283,54,108,0.5,1,1,1,53,107,0.495,0.505,38,52,0.731,33,23,56,5,8,5,18,54,147
Ivan Vujic,Spirou Charleroi,10,112,8,19,0.421,0,0,,8,19,0.421,0.421,4,14,0.286,6,20,26,3,1,0,11,24,20
Ivica Skalabrin,KK Zadar,3,22,1,2,0.5,0,1,0,1,1,1,0.5,2,2,1,1,0,1,1,0,0,1,6,4
Jacques Stas,Spirou Charleroi,13,387,33,97,0.34,17,50,0.34,16,47,0.34,0.428,37,49,0.755,5,10,15,34,4,0,33,35,120
Jaka Lakovic,KK Krka,14,455,85,173,0.491,34,78,0.436,51,95,0.537,0.59,89,100,0.89,7,23,30,53,28,0,35,41,293
Jakov Vladovic,KK Zadar,3,32,3,6,0.5,1,3,0.333,2,3,0.667,0.583,1,2,0.5,0,2,2,2,1,0,0,4,8
James Brewer,KK Krka,5,84,15,38,0.395,4,18,0.222,11,20,0.55,0.447,5,8,0.625,3,5,8,8,4,2,10,20,34
James Forrest,Olympiacos,20,494,95,181,0.525,1,2,0.5,94,179,0.525,0.528,59,85,0.694,37,83,120,10,13,5,33,74,250
Jasmin Hukic,KK Union Olimpija,17,243,32,81,0.395,15,44,0.341,17,37,0.459,0.488,7,10,0.7,17,16,33,8,10,1,16,31,86
Jean Marc Jaumin,Real Madrid,5,79,10,15,0.667,5,6,0.833,5,9,0.556,0.833,7,7,1,1,9,10,10,1,0,9,11,32
Jeff Kent,London Towers,11,307,26,59,0.441,10,28,0.357,16,31,0.516,0.525,7,17,0.412,17,47,64,13,21,4,28,31,69
Jim Bilba,AEK Athens,18,418,22,51,0.431,8,23,0.348,14,28,0.5,0.51,11,18,0.611,27,47,74,19,19,9,16,48,63
Jim Potter,Spirou Charleroi,12,274,36,88,0.409,22,45,0.489,14,43,0.326,0.534,18,24,0.75,10,23,33,7,3,4,7,31,112
Jiri Welsch,KK Union Olimpija,20,622,105,235,0.447,24,74,0.324,81,161,0.503,0.498,84,99,0.848,22,42,64,45,25,2,49,53,318
John Celestand,Skipper Fortitudo Bologna,5,107,7,21,0.333,4,11,0.364,3,10,0.3,0.429,4,7,0.571,2,8,10,14,1,0,9,13,22
John Celestand,Adecco ASVEL Villeurbanne,8,207,26,61,0.426,7,23,0.304,19,38,0.5,0.484,25,30,0.833,0,10,10,48,5,1,20,24,82
John Jerome,Spirou Charleroi,14,337,73,144,0.507,10,24,0.417,63,120,0.525,0.542,29,40,0.725,44,48,92,18,16,2,30,54,185
John White,London Towers,10,275,42,114,0.368,16,46,0.348,26,68,0.382,0.439,20,27,0.741,11,30,41,8,9,2,30,32,120
Johnny Rogers,Panathinaikos,22,374,38,74,0.514,14,30,0.467,24,44,0.545,0.608,25,30,0.833,4,41,45,14,8,2,18,59,115
Jon Cortaberria,Unicaja Malaga,1,7,1,2,0.5,1,1,1,0,1,0,0.75,0,0,,2,0,2,1,0,0,0,1,3
Jonathan Kerner,CSKA Moscow,1,4,0,0,,0,0,,0,0,,,0,0,,0,0,0,0,0,0,0,1,0
Jordi Grimau,FC Barcelona,1,3,0,1,0,0,0,,0,1,0,0,0,0,,0,0,0,0,0,0,0,0,0
Jorg Lutcke,Alba Berlin,14,321,28,66,0.424,8,33,0.242,20,33,0.606,0.485,18,23,0.783,9,23,32,16,9,0,16,54,82
Jorge Garbajosa,Benetton Treviso,20,528,76,163,0.466,27,77,0.351,49,86,0.57,0.549,51,62,0.823,37,81,118,21,39,12,28,62,230
Jorge Komadinic,Adecco ASVEL Villeurbanne,1,1,0,2,0,0,0,,0,2,0,0,0,0,,0,0,0,0,0,0,0,1,0
Joseph Blair,Scavolini Pesaro,14,479,89,141,0.631,0,1,0,89,140,0.636,0.631,41,66,0.621,55,112,167,10,28,9,26,43,219
Josip Sesar,Cibona Zagreb,9,242,55,109,0.505,21,49,0.429,34,60,0.567,0.601,13,23,0.565,0,10,10,31,6,0,17,23,144
Josko Poljak,CSKA Moscow,5,37,5,7,0.714,0,0,,5,7,0.714,0.714,0,0,,6,2,8,0,1,1,2,10,10
Jovo Stanojevic,Partizan,14,435,90,156,0.577,0,0,,90,156,0.577,0.577,50,71,0.704,41,73,114,28,13,4,46,54,230
JR Holden,AEK Athens,20,714,115,318,0.362,45,149,0.302,70,169,0.414,0.432,69,112,0.616,12,36,48,56,28,0,34,39,344
Juan Carlos Navarro,FC Barcelona,17,323,58,134,0.433,20,60,0.333,38,74,0.514,0.507,40,49,0.816,3,23,26,33,17,0,24,16,176
Juan Lopez,Real Madrid,1,3,1,1,1,0,0,,1,1,1,1,0,0,,0,0,0,0,0,0,0,0,2
Julien Defosse,Spirou Charleroi,4,53,1,10,0.1,1,6,0.167,0,4,0,0.15,0,0,,3,8,11,2,1,0,4,3,3
Jurica Golemac,KK Union Olimpija,19,382,66,141,0.468,14,34,0.412,52,107,0.486,0.518,26,31,0.839,23,44,67,26,17,8,41,63,172
Jurica Ruzic,KK Zadar,2,71,5,18,0.278,1,7,0.143,4,11,0.364,0.306,4,4,1,2,5,7,1,1,0,2,7,15
Jurij Zdovc,KK Union Olimpija,17,456,36,101,0.356,23,70,0.329,13,31,0.419,0.47,17,21,0.81,5,30,35,36,17,5,23,48,112
Juris Umbrasko,CSKA Moscow,1,10,0,1,0,0,0,,0,1,0,0,0,0,,0,0,0,2,0,0,0,0,0
Kai Nurnberger,Opel Skyliners,9,174,10,35,0.286,6,16,0.375,4,19,0.211,0.371,7,10,0.7,1,10,11,20,4,1,10,26,33
Kaspars Kambala,Efes Pilsen,20,606,129,230,0.561,0,0,,129,230,0.561,0.561,80,111,0.721,51,87,138,8,12,6,28,67,338
Kaya Peker,Efes Pilsen,16,219,10,32,0.313,0,0,,10,32,0.313,0.313,12,25,0.48,27,37,64,7,9,10,12,45,32
Kenneth Inge,BC Zalgiris,3,68,3,8,0.375,0,0,,3,8,0.375,0.375,1,4,0.25,6,4,10,1,4,0,2,5,7
Kerem Gonlum,Fenerbahçe,18,319,49,96,0.51,0,0,,49,96,0.51,0.51,13,20,0.65,29,40,69,10,9,5,26,39,111
Kerem Tunceri,Efes Pilsen,19,509,30,104,0.288,6,34,0.176,24,70,0.343,0.317,15,23,0.652,5,28,33,53,18,5,27,56,81
Kestutis Marciulonis,BC Zalgiris,5,97,12,30,0.4,2,9,0.222,10,21,0.476,0.433,8,10,0.8,2,9,11,6,2,0,13,12,34
Kostas Paschalis,AEK Athens,9,40,0,3,0,0,0,,0,3,0,0,0,2,0,3,5,8,0,1,0,6,11,0
Kostas Tsartsaris,Peristeri,14,413,50,111,0.45,3,21,0.143,47,90,0.522,0.464,40,62,0.645,24,64,88,24,14,9,34,44,143
Kyle Hill,Adecco ASVEL Villeurbanne,14,419,67,154,0.435,38,91,0.418,29,63,0.46,0.558,16,21,0.762,10,16,26,25,13,4,16,27,188
Kyle Milling,Elan Bearnais Pau-Orthez,14,134,7,16,0.438,0,0,,7,16,0.438,0.438,5,11,0.455,6,20,26,8,4,3,9,27,19
Larry Middleton,Scavolini Pesaro,19,401,53,127,0.417,33,90,0.367,20,37,0.541,0.547,12,15,0.8,2,39,41,20,14,2,27,66,151
Laurent Foirest,TAU Ceramica,18,479,53,140,0.379,28,79,0.354,25,61,0.41,0.479,46,57,0.807,5,48,53,28,31,4,23,56,180
Lazaros Papadopoulos,Panathinaikos,19,293,51,80,0.638,0,0,,51,80,0.638,0.638,24,31,0.774,29,48,77,18,7,9,30,49,126
Louis Rowe,Spirou Charleroi,13,391,63,152,0.414,17,56,0.304,46,96,0.479,0.47,34,43,0.791,8,32,40,25,17,2,35,49,177
Lucio Angulo,Real Madrid,19,416,48,97,0.495,6,32,0.188,42,65,0.646,0.526,48,54,0.889,13,36,49,29,25,6,38,56,150
Luis Scola,TAU Ceramica,20,474,126,183,0.689,1,3,0.333,125,180,0.694,0.691,65,97,0.67,40,52,92,23,25,6,40,66,318
Maciej Lampe,Real Madrid,3,22,4,8,0.5,1,2,0.5,3,6,0.5,0.563,0,0,,0,2,2,0,0,0,0,7,9
Maciej Zielinski,Slask Wroclaw,11,319,40,97,0.412,11,37,0.297,29,60,0.483,0.469,17,23,0.739,8,35,43,18,18,1,18,28,108
Manolis Papamakarios,Peristeri,8,203,18,46,0.391,9,26,0.346,9,20,0.45,0.489,22,27,0.815,1,14,15,16,13,1,14,28,67
Manu Ginobili,Kinder Bologna,22,627,113,251,0.45,32,94,0.34,81,157,0.516,0.514,91,117,0.778,23,61,84,66,56,7,53,71,349
Marcelo Nicola,Benetton Treviso,20,472,78,182,0.429,50,132,0.379,28,50,0.56,0.566,36,47,0.766,10,81,91,23,21,11,30,52,242
Marco Samanic,KK Krka,14,235,39,69,0.565,7,21,0.333,32,48,0.667,0.616,24,31,0.774,16,27,43,15,1,6,23,45,109
Marcus Brown,Efes Pilsen,19,663,97,214,0.453,44,104,0.423,53,110,0.482,0.556,95,108,0.88,6,49,55,64,34,2,34,55,333
Marcus Goree,Opel Skyliners,14,494,95,205,0.463,15,47,0.319,80,158,0.506,0.5,48,73,0.658,40,73,113,20,20,21,30,32,253
Marijan Mance,Cibona Zagreb,12,216,31,62,0.5,4,11,0.364,27,51,0.529,0.532,14,21,0.667,14,17,31,6,4,0,12,24,80
Marin Vrsaljko,KK Zadar,5,23,2,6,0.333,0,1,0,2,5,0.4,0.333,0,1,0,0,2,2,0,0,0,1,3,4
Mario Bennett,Unicaja Malaga,3,34,4,8,0.5,0,0,,4,8,0.5,0.5,1,1,1,3,3,6,0,0,2,1,7,9
Mario Stojic,Benetton Treviso,14,266,31,74,0.419,14,37,0.378,17,37,0.459,0.514,8,13,0.615,10,20,30,14,14,2,19,37,84
Mark Brisker,Maccabi Tel Aviv,11,130,19,37,0.514,16,29,0.552,3,8,0.375,0.73,8,9,0.889,0,8,8,2,2,0,1,17,62
Marko Jaric,Kinder Bologna,21,592,108,224,0.482,19,71,0.268,89,153,0.582,0.525,47,79,0.595,23,67,90,53,47,3,42,55,282
Marko Milic,Skipper Fortitudo Bologna,18,382,68,137,0.496,4,15,0.267,64,122,0.525,0.511,27,41,0.659,36,28,64,25,32,2,35,50,167
Marko Pesic,Alba Berlin,10,269,30,81,0.37,14,41,0.341,16,40,0.4,0.457,20,27,0.741,5,15,20,22,7,1,18,28,94
Marko Popovic,KK Zadar,11,334,47,117,0.402,20,67,0.299,27,50,0.54,0.487,39,48,0.813,3,17,20,44,18,0,19,36,153
Marko Tusek,Scavolini Pesaro,20,544,77,155,0.497,20,44,0.455,57,111,0.514,0.561,32,49,0.653,44,60,104,13,10,1,30,50,206
Massimo Bulleri,Benetton Treviso,21,275,33,77,0.429,10,30,0.333,23,47,0.489,0.494,14,16,0.875,3,31,34,19,18,1,25,33,90
Mate Skelin,KK Krka,14,458,78,129,0.605,0,0,,78,129,0.605,0.605,84,120,0.7,46,91,137,24,7,10,32,44,240
Matej Mamic,Cibona Zagreb,12,376,46,99,0.465,14,47,0.298,32,52,0.615,0.535,15,31,0.484,30,37,67,24,13,2,14,43,121
Matjaz Smodis,Kinder Bologna,22,484,93,161,0.578,25,60,0.417,68,101,0.673,0.655,44,49,0.898,32,79,111,10,17,13,32,61,255
Matteo Panichi,Scavolini Pesaro,2,7,0,1,0,0,1,0,0,0,,0,0,0,,2,1,3,0,0,1,0,1,0
Matteo Pecchia,Skipper Fortitudo Bologna,1,4,1,1,1,0,0,,1,1,1,1,0,2,0,0,0,0,0,0,0,0,1,2
Maurice Carter,Peristeri,4,74,7,21,0.333,0,3,0,7,18,0.389,0.333,3,4,0.75,2,5,7,0,5,0,7,6,17
Mehmet Okur,Efes Pilsen,20,544,81,180,0.45,14,36,0.389,67,144,0.465,0.489,65,87,0.747,48,83,131,18,20,16,33,62,241
Melvin Booker,Scavolini Pesaro,20,676,118,268,0.44,45,116,0.388,73,152,0.48,0.524,62,75,0.827,6,48,54,75,31,0,43,55,343
Michael Andersen,Peristeri,12,289,48,74,0.649,1,1,1,47,73,0.644,0.655,31,46,0.674,22,42,64,6,9,5,29,33,128
Michael Hawkins,Slask Wroclaw,14,447,53,127,0.417,24,73,0.329,29,54,0.537,0.512,34,42,0.81,7,24,31,70,19,0,52,37,164
Michael Wright,Slask Wroclaw,8,220,41,88,0.466,0,0,,41,88,0.466,0.466,33,38,0.868,20,49,69,4,7,1,24,14,115
Michalis Kakiouzis,AEK Athens,20,626,97,195,0.497,13,47,0.277,84,148,0.568,0.531,91,118,0.771,61,104,165,18,22,2,41,53,298
Michele Ferri,Scavolini Pesaro,2,2,0,1,0,0,0,,0,1,0,0,0,0,,0,0,0,0,0,0,0,0,0
Michele Maggioli,Scavolini Pesaro,19,310,34,68,0.5,3,8,0.375,31,60,0.517,0.522,1,1,1,26,46,72,15,7,13,13,52,72
Mickael Pietrus,Elan Bearnais Pau-Orthez,14,272,30,83,0.361,14,48,0.292,16,35,0.457,0.446,19,30,0.633,14,33,47,16,10,11,22,36,93
Michalis Pelekanos,Peristeri,14,304,21,52,0.404,6,25,0.24,15,27,0.556,0.462,17,25,0.68,7,37,44,10,13,3,14,53,65
Mikhail Mikhailov,Ural Great Perm,19,485,104,172,0.605,1,2,0.5,103,170,0.606,0.608,27,60,0.45,39,92,131,26,19,31,27,57,236
Milan Gurovic,Unicaja Malaga,11,249,35,104,0.337,16,50,0.32,19,54,0.352,0.413,38,46,0.826,11,32,43,7,3,0,13,21,124
Milan Tomic,Olympiacos,19,391,32,123,0.26,18,82,0.22,14,41,0.341,0.333,31,39,0.795,7,17,24,33,14,1,12,40,113
Miljan Goljovic,Fenerbahçe,19,433,77,181,0.425,30,77,0.39,47,104,0.452,0.508,33,38,0.868,10,37,47,16,20,2,32,49,217
Milos Mirkovic,KK Krka,2,12,2,8,0.25,0,0,,2,8,0.25,0.25,0,0,,2,3,5,0,0,0,0,1,4
Milos Vujanic,Partizan,12,334,55,121,0.455,22,57,0.386,33,64,0.516,0.545,30,40,0.75,4,32,36,34,10,1,22,48,162
Mindaugas Timinskas,TAU Ceramica,10,224,26,54,0.481,4,15,0.267,22,39,0.564,0.519,18,22,0.818,8,20,28,11,16,3,11,32,74
Miroslav Beric,Scavolini Pesaro,16,458,56,141,0.397,29,75,0.387,27,66,0.409,0.5,67,83,0.807,5,20,25,30,10,0,29,43,208
Mirsad Turkcan,CSKA Moscow,17,571,107,207,0.517,13,39,0.333,94,168,0.56,0.548,73,103,0.709,71,146,217,35,21,21,62,55,300
Mithat Demirel,Alba Berlin,8,75,3,14,0.214,2,8,0.25,1,6,0.167,0.286,7,10,0.7,1,2,3,8,2,0,6,16,15
Moustapha Sonko,Unicaja Malaga,13,338,43,102,0.422,14,41,0.341,29,61,0.475,0.49,38,44,0.864,6,25,31,23,12,3,21,39,138
Muratcan Guler,Fenerbahçe,15,134,7,22,0.318,3,12,0.25,4,10,0.4,0.386,5,8,0.625,8,9,17,12,7,1,9,13,22
Mustafa Abi,Fenerbahçe,11,110,9,19,0.474,4,6,0.667,5,13,0.385,0.579,7,14,0.5,1,12,13,8,3,0,5,21,29
Nadav Henefeld,Maccabi Tel Aviv,20,454,37,66,0.561,0,1,0,37,65,0.569,0.561,8,22,0.364,18,43,61,49,27,3,27,72,82
Nate Huffman,Maccabi Tel Aviv,20,528,97,181,0.536,6,16,0.375,91,165,0.552,0.552,79,105,0.752,41,107,148,19,13,10,37,53,279
Nedim Dal,KK Union Olimpija,3,16,2,6,0.333,0,0,,2,6,0.333,0.333,0,0,,1,2,3,0,1,0,2,3,4
Nemanja Jelesijevic,KK Krka,7,42,5,14,0.357,0,3,0,5,11,0.455,0.357,5,8,0.625,1,6,7,1,1,3,7,6,15
Nenad Canak,Partizan,14,361,46,102,0.451,23,41,0.561,23,61,0.377,0.564,25,32,0.781,8,36,44,7,18,0,21,48,140
Nenad Krstic,Partizan,13,256,20,52,0.385,0,1,0,20,51,0.392,0.385,22,37,0.595,26,31,57,2,7,8,13,48,62
Nikita Morgunov,CSKA Moscow,8,204,23,55,0.418,4,17,0.235,19,38,0.5,0.455,9,15,0.6,7,30,37,7,5,10,8,18,59
Niklas Lutcke,Opel Skyliners,6,32,3,10,0.3,3,10,0.3,0,0,,0.45,1,2,0.5,3,3,6,1,0,0,1,6,10
Nikola Jestratijevic,KK Buducnost,9,202,43,67,0.642,0,0,,43,67,0.642,0.642,27,42,0.643,21,36,57,4,8,7,19,39,113
Nikola Prkacin,Cibona Zagreb,14,356,51,103,0.495,0,2,0,51,101,0.505,0.495,38,57,0.667,23,59,82,32,18,10,37,50,140
Nikola Radulovic,Adecco ASVEL Villeurbanne,12,346,40,104,0.385,15,47,0.319,25,57,0.439,0.457,30,37,0.811,22,36,58,23,14,7,19,44,125
Nikola Vujcic,Maccabi Tel Aviv,2,12,2,5,0.4,0,2,0,2,3,0.667,0.4,0,0,,1,0,1,0,2,0,1,1,4
Nikola Vujcic,Adecco ASVEL Villeurbanne,12,354,78,150,0.52,10,36,0.278,68,114,0.596,0.553,50,70,0.714,18,71,89,23,18,10,26,29,216
Nikolai Alexeev,CSKA Moscow,4,69,2,7,0.286,0,0,,2,7,0.286,0.286,4,4,1,2,8,10,2,1,1,3,11,8
Nikolaos Bountouris,Olympiacos,12,137,6,14,0.429,3,11,0.273,3,3,1,0.536,1,4,0.25,3,6,9,12,11,0,8,27,16
Nikolaos Oikonomou,FC Barcelona,12,154,14,45,0.311,9,20,0.45,5,25,0.2,0.411,15,20,0.75,12,13,25,9,5,1,9,22,52
Nikolay Padius,CSKA Moscow,3,27,3,5,0.6,0,0,,3,5,0.6,0.6,2,4,0.5,0,1,1,3,1,2,3,6,8
Nikoloz Tskitishvili,Benetton Treviso,6,36,3,8,0.375,0,2,0,3,6,0.5,0.375,0,2,0,4,3,7,2,1,1,1,6,6
Nikos Hatzis,AEK Athens,17,281,30,75,0.4,12,36,0.333,18,39,0.462,0.48,41,58,0.707,12,22,34,13,4,0,18,38,113
Nikos Zisis,AEK Athens,19,272,28,56,0.5,9,20,0.45,19,36,0.528,0.58,20,34,0.588,7,10,17,20,8,0,16,42,85
Omer Onan,Efes Pilsen,20,438,73,144,0.507,27,59,0.458,46,85,0.541,0.601,19,46,0.413,7,16,23,12,14,2,23,53,192
Paco Vazquez,Unicaja Malaga,13,216,23,62,0.371,15,39,0.385,8,23,0.348,0.492,6,8,0.75,5,10,15,13,13,0,17,28,67
Panagiotis Liadelis,Ural Great Perm,9,273,57,112,0.509,6,18,0.333,51,94,0.543,0.536,55,61,0.902,9,17,26,18,9,0,14,19,175
Panagiotis Mantzanas,Olympiacos,1,2,0,0,,0,0,,0,0,,,2,2,1,0,0,0,1,1,0,1,0,2
Paolo Barlera,Kinder Bologna,8,35,2,5,0.4,0,0,,2,5,0.4,0.4,5,10,0.5,2,6,8,0,2,1,6,9,9
Pascal Roller,Opel Skyliners,14,463,55,136,0.404,32,82,0.39,23,54,0.426,0.522,24,33,0.727,10,28,38,41,17,0,34,39,166
Patrick Femerling,Olympiacos,14,248,27,57,0.474,1,1,1,26,56,0.464,0.482,28,31,0.903,28,36,64,6,10,8,14,37,83
Pawel Wiekiera,Slask Wroclaw,9,101,12,31,0.387,6,21,0.286,6,10,0.6,0.484,0,0,,4,13,17,2,1,3,3,16,30
Pepe Sanchez,Panathinaikos,19,342,31,68,0.456,6,22,0.273,25,46,0.543,0.5,20,27,0.741,1,33,34,42,32,0,32,58,88
Periklis Dorkofikis,Olympiacos,1,1,0,0,,0,0,,0,0,,,0,0,,0,0,0,0,0,0,2,0,0
Pero Antic,AEK Athens,7,32,3,6,0.5,0,1,0,3,5,0.6,0.5,0,0,,6,2,8,1,1,0,2,10,6
Petar Arsic,KK Buducnost,3,21,2,9,0.222,0,0,,2,9,0.222,0.222,4,4,1,2,3,5,1,0,0,5,5,8
Peter Cornell,Partizan,2,8,0,0,,0,0,,0,0,,,0,0,,0,0,0,0,1,1,1,0,0
Peter Hoffman,Adecco ASVEL Villeurbanne,3,26,0,6,0,0,5,0,0,1,0,0,1,2,0.5,0,3,3,1,0,0,1,4,1
Peter Van paassen,BC Oostende,14,217,21,48,0.438,0,0,,21,48,0.438,0.438,19,26,0.731,16,35,51,6,2,2,9,44,61
Phil Hickey,London Towers,14,336,36,80,0.45,1,3,0.333,35,77,0.455,0.456,13,37,0.351,20,58,78,9,6,5,22,48,86
Piotr Szybilski,Slask Wroclaw,3,53,7,16,0.438,0,2,0,7,14,0.5,0.438,5,7,0.714,3,6,9,0,1,1,2,14,19
Predrag Materic,Partizan,14,190,10,23,0.435,6,11,0.545,4,12,0.333,0.565,20,24,0.833,4,18,22,5,2,0,16,33,46
Quadre Michael Lollis,Fenerbahçe,18,497,75,143,0.524,1,5,0.2,74,138,0.536,0.528,38,69,0.551,67,86,153,41,28,5,35,69,189
Radisav Curcic,Maccabi Tel Aviv,6,60,9,20,0.45,0,0,,9,20,0.45,0.45,6,10,0.6,3,13,16,0,0,1,5,13,24
Rafal Bigus,Slask Wroclaw,9,85,6,20,0.3,0,0,,6,20,0.3,0.3,5,14,0.357,9,16,25,2,0,3,6,15,17
Raimonds Miglieniks,CSKA Moscow,14,172,9,30,0.3,6,23,0.261,3,7,0.429,0.4,6,10,0.6,2,9,11,29,10,0,13,18,30
Ralph Biggs,BC Oostende,14,515,87,177,0.492,10,32,0.313,77,145,0.531,0.52,60,75,0.8,14,71,85,45,30,4,31,47,244
Ramunas Petraitis,Ural Great Perm,7,44,3,7,0.429,2,2,1,1,5,0.2,0.571,1,6,0.167,1,0,1,1,1,0,4,3,9
Rashard Griffith,Kinder Bologna,13,339,46,75,0.613,0,0,,46,75,0.613,0.613,20,49,0.408,28,61,89,13,14,8,35,45,112
Raul Lopez,Real Madrid,4,87,13,30,0.433,4,13,0.308,9,17,0.529,0.5,10,12,0.833,1,7,8,13,9,0,3,9,40
Raul Mena,Real Madrid,2,12,2,4,0.5,1,2,0.5,1,2,0.5,0.625,1,4,0.25,0,2,2,0,0,0,1,4,6
Reggie Freeman,Cibona Zagreb,12,301,41,94,0.436,15,51,0.294,26,43,0.605,0.516,31,39,0.795,11,40,51,20,11,5,24,42,128
Remon Van de Hare,FC Barcelona,1,9,2,3,0.667,0,0,,2,3,0.667,0.667,0,0,,0,0,0,0,0,0,1,2,4
Riccardo Pittis,Benetton Treviso,21,500,54,94,0.574,0,3,0,54,91,0.593,0.574,23,57,0.404,15,58,73,61,37,4,16,55,131
Riste Stefanov,KK Union Olimpija,1,3,1,2,0.5,1,1,1,0,1,0,0.75,0,0,,0,1,1,0,0,0,0,0,3
Robert Maras,Opel Skyliners,12,253,32,59,0.542,0,1,0,32,58,0.552,0.542,10,15,0.667,26,38,64,3,9,5,17,33,74
Robert Skibniewski,Slask Wroclaw,3,22,0,2,0,0,1,0,0,1,0,0,0,0,,0,0,0,4,0,0,4,4,0
Robert Wintermantel,Opel Skyliners,5,14,2,2,1,1,1,1,1,1,1,1.25,2,2,1,0,2,2,0,0,0,1,3,7
Robert Youngblood,London Towers,9,142,12,39,0.308,0,0,,12,39,0.308,0.308,10,14,0.714,14,15,29,5,1,0,15,36,34
Roberto Duenas,FC Barcelona,19,352,61,106,0.575,0,0,,61,106,0.575,0.575,33,55,0.6,53,64,117,10,13,10,44,45,155
Roberto Graziano,Kinder Bologna,1,1,2,2,1,0,0,,2,2,1,1,0,0,,0,0,0,0,0,0,0,0,4
Roberts Stelmahers,Fenerbahçe,19,382,38,93,0.409,14,41,0.341,24,52,0.462,0.484,34,43,0.791,6,25,31,29,18,0,16,37,124
Rod Sellers,Elan Bearnais Pau-Orthez,14,426,77,144,0.535,0,2,0,77,142,0.542,0.535,54,72,0.75,27,64,91,12,7,5,26,42,208
Rodrigo De La Fuente,FC Barcelona,16,344,46,84,0.548,2,13,0.154,44,71,0.62,0.56,24,36,0.667,10,35,45,22,22,0,21,28,118
Roger Esteller,Elan Bearnais Pau-Orthez,14,435,78,167,0.467,22,53,0.415,56,114,0.491,0.533,47,68,0.691,11,27,38,38,7,1,23,31,225
Roger Huggins,Spirou Charleroi,14,417,60,156,0.385,4,12,0.333,56,144,0.389,0.397,59,87,0.678,22,68,90,16,32,9,30,49,183
Rolandas Matulis,BC Zalgiris,9,120,10,25,0.4,0,0,,10,25,0.4,0.4,5,9,0.556,10,13,23,2,4,1,6,22,25
Ronald Ellis,Spirou Charleroi,13,386,58,112,0.518,18,46,0.391,40,66,0.606,0.598,27,37,0.73,21,40,61,18,12,4,28,34,161
Ronnie Baker,London Towers,12,144,10,19,0.526,5,12,0.417,5,7,0.714,0.658,5,8,0.625,1,4,5,14,1,0,10,16,30
Roy Rogers,CSKA Moscow,6,61,3,11,0.273,0,0,,3,11,0.273,0.273,2,4,0.5,5,9,14,1,2,1,2,8,8
Ruben Wolkowyski,CSKA Moscow,7,206,31,57,0.544,3,7,0.429,28,50,0.56,0.57,16,17,0.941,13,40,53,5,6,3,15,22,81
Rumeal Robinson,KK Zadar,10,310,63,152,0.414,18,59,0.305,45,93,0.484,0.474,34,43,0.791,6,27,33,33,16,0,40,42,178
Rumeal Robinson,Skipper Fortitudo Bologna,2,25,3,5,0.6,1,2,0.5,2,3,0.667,0.7,0,0,,0,1,1,3,0,0,2,6,7
Ruslan Avleev,Ural Great Perm,20,598,123,200,0.615,20,36,0.556,103,164,0.628,0.665,106,130,0.815,47,76,123,34,14,5,46,48,372
Rytis Vaisvila,Ural Great Perm,10,163,13,39,0.333,2,11,0.182,11,28,0.393,0.359,11,15,0.733,4,13,17,12,5,0,9,12,39
Sam Hagginas,Peristeri,3,16,2,7,0.286,0,0,,2,7,0.286,0.286,0,0,,4,4,8,1,1,0,3,3,4
Sam Rotsaert,BC Oostende,6,28,3,9,0.333,0,2,0,3,7,0.429,0.333,0,0,,1,0,1,3,2,0,2,8,6
Samo Grum,KK Krka,14,300,38,86,0.442,9,29,0.31,29,57,0.509,0.494,16,21,0.762,0,17,17,12,10,0,11,62,101
Sandro Nicevic,KK Union Olimpija,7,111,19,38,0.5,0,0,,19,38,0.5,0.5,7,11,0.636,8,14,22,4,6,4,6,17,45
Sani Becirovic,Kinder Bologna,13,290,34,84,0.405,10,35,0.286,24,49,0.49,0.464,48,62,0.774,4,36,40,33,19,2,27,39,126
Sarunas Jasikevicius,FC Barcelona,18,425,70,139,0.504,35,78,0.449,35,61,0.574,0.629,34,39,0.872,8,29,37,61,17,2,52,53,209
Sasha Pavlovic,KK Buducnost,2,6,0,3,0,0,1,0,0,2,0,0,0,0,,0,0,0,0,0,0,1,1,0
Saulius Stombergas,Efes Pilsen,20,552,73,148,0.493,38,78,0.487,35,70,0.5,0.622,47,61,0.77,18,41,59,24,33,2,36,68,231
Sergei Chikalkin,Benetton Treviso,21,519,82,169,0.485,33,74,0.446,49,95,0.516,0.583,44,48,0.917,7,20,27,18,15,0,22,28,241
Sergey Panov,Ural Great Perm,20,482,62,116,0.534,11,38,0.289,51,78,0.654,0.582,46,53,0.868,22,81,103,43,26,9,40,78,181
Sergi Vidal,TAU Ceramica,16,286,20,56,0.357,3,15,0.2,17,41,0.415,0.384,20,32,0.625,7,11,18,18,19,2,13,23,63
Sherman Hamilton,BC Zalgiris,5,46,5,13,0.385,3,7,0.429,2,6,0.333,0.5,3,6,0.5,0,3,3,2,3,0,5,2,16
Silas Cheung,London Towers,14,344,23,65,0.354,12,43,0.279,11,22,0.5,0.446,7,10,0.7,14,23,37,13,11,0,17,26,65
Silvio Gigena,Scavolini Pesaro,20,328,38,90,0.422,17,46,0.37,21,44,0.477,0.517,22,29,0.759,24,33,57,8,15,2,18,40,115
Sime Spralja,KK Zadar,7,46,4,10,0.4,0,0,,4,10,0.4,0.4,4,6,0.667,6,2,8,0,1,0,2,16,12
Simon Petrov,Adecco ASVEL Villeurbanne,11,150,21,44,0.477,8,24,0.333,13,20,0.65,0.568,17,18,0.944,1,5,6,12,4,0,10,24,67
Spiros Panteliadis,AEK Athens,10,67,8,17,0.471,2,7,0.286,6,10,0.6,0.529,9,12,0.75,1,5,6,6,4,0,7,6,27
Srdjan Zivkovic,Partizan,1,3,0,1,0,0,0,,0,1,0,0,0,0,,0,0,0,0,0,0,0,0,0
Stefano Attruia,Real Madrid,7,190,21,41,0.512,10,26,0.385,11,15,0.733,0.634,9,10,0.9,1,7,8,22,6,0,10,18,61
Stefano Garris,Alba Berlin,10,209,24,65,0.369,10,31,0.323,14,34,0.412,0.446,14,18,0.778,7,21,28,5,10,0,6,25,72
Stefano Mancinelli,Skipper Fortitudo Bologna,3,22,2,5,0.4,1,3,0.333,1,2,0.5,0.5,0,0,,0,1,1,0,0,0,1,4,5
Stephane Risacher,Olympiacos,20,532,73,143,0.51,22,53,0.415,51,90,0.567,0.587,35,47,0.745,16,58,74,19,14,9,27,46,203
Stephen Barnes,London Towers,4,36,2,11,0.182,0,1,0,2,10,0.2,0.182,2,2,1,1,4,5,0,1,0,3,4,6
Stephen Tison,Spirou Charleroi,5,14,1,3,0.333,0,2,0,1,1,1,0.333,4,4,1,0,1,1,2,0,0,1,4,6
Stevan Nadjfeji,Partizan,6,49,3,11,0.273,0,2,0,3,9,0.333,0.273,2,2,1,4,2,6,3,1,0,6,12,8
Steve Woodberry,BC Zalgiris,14,437,68,137,0.496,7,21,0.333,61,116,0.526,0.522,32,46,0.696,16,47,63,43,20,2,30,21,175
Stipe Modric,KK Union Olimpija,16,242,12,29,0.414,2,9,0.222,10,20,0.5,0.448,7,12,0.583,14,22,36,12,22,5,15,49,33
Stipo Papic,Alba Berlin,8,47,8,14,0.571,1,1,1,7,13,0.538,0.607,2,4,0.5,3,8,11,1,3,1,4,15,19
Stuart Robbins,London Towers,14,204,28,75,0.373,0,2,0,28,73,0.384,0.373,11,23,0.478,17,22,39,4,3,3,20,24,67
Sven Schultze,Alba Berlin,14,157,23,50,0.46,10,22,0.455,13,28,0.464,0.56,3,6,0.5,7,17,24,3,1,1,10,37,59
Tal Burstein,Maccabi Tel Aviv,20,412,46,109,0.422,17,43,0.395,29,66,0.439,0.5,22,31,0.71,5,35,40,30,12,5,22,56,131
Teo Cizmic,BC Oostende,14,211,28,62,0.452,17,36,0.472,11,26,0.423,0.589,12,16,0.75,4,19,23,8,5,0,11,19,85
Teoman Ozturk,Alba Berlin,14,259,35,68,0.515,5,20,0.25,30,48,0.625,0.551,17,22,0.773,12,22,34,4,11,6,17,28,92
Terrell Myers,London Towers,13,400,82,188,0.436,25,76,0.329,57,112,0.509,0.503,21,28,0.75,9,28,37,17,10,0,36,40,210
Thalamus McGhee,Adecco ASVEL Villeurbanne,4,65,10,20,0.5,0,0,,10,20,0.5,0.5,1,8,0.125,14,17,31,3,1,0,7,16,21
Thanassis Efthimiou,Peristeri,8,75,7,19,0.368,1,7,0.143,6,12,0.5,0.395,5,8,0.625,4,7,11,7,2,2,6,10,20
Theodore Allen,London Towers,4,106,13,34,0.382,0,8,0,13,26,0.5,0.382,7,11,0.636,12,13,25,3,10,1,13,17,33
Theodoros Papaloukas,Olympiacos,19,511,52,111,0.468,9,27,0.333,43,84,0.512,0.509,47,70,0.671,13,43,56,76,38,3,46,62,160
Thierry Gadou,Elan Bearnais Pau-Orthez,1,19,0,1,0,0,1,0,0,0,,0,3,4,0.75,0,4,4,1,1,0,0,1,3
Thomas Van de vondel,Spirou Charleroi,11,113,6,14,0.429,0,4,0,6,10,0.6,0.429,0,1,0,3,7,10,4,1,0,7,21,12
Tim Nees,Adecco ASVEL Villeurbanne,12,191,29,59,0.492,0,0,,29,59,0.492,0.492,15,21,0.714,22,34,56,10,7,2,7,35,73
Tomas Masiulis,BC Zalgiris,11,286,39,75,0.52,8,15,0.533,31,60,0.517,0.573,12,22,0.545,26,39,65,19,12,8,21,31,98
Tomas Pacesas,Slask Wroclaw,5,77,5,13,0.385,5,7,0.714,0,6,0,0.577,0,0,,2,4,6,7,1,0,7,10,15
Tomislav Knezevic,KK Zadar,4,29,2,4,0.5,1,1,1,1,3,0.333,0.625,2,2,1,0,0,0,4,0,0,0,4,7
Tomislav Ruzic,KK Zadar,14,351,54,100,0.54,8,20,0.4,46,80,0.575,0.58,18,20,0.9,29,49,78,5,13,7,12,50,134
Tommy Thorwarth,Alba Berlin,7,82,5,13,0.385,2,8,0.25,3,5,0.6,0.462,5,6,0.833,6,4,10,3,4,0,4,18,17
Toni Dijan,KK Zadar,7,124,20,34,0.588,0,1,0,20,33,0.606,0.588,8,14,0.571,8,13,21,11,4,1,8,15,48
Tonin Llorente,Real Madrid,9,68,4,7,0.571,2,5,0.4,2,2,1,0.714,1,2,0.5,0,9,9,8,1,0,5,11,11
Tunji Awojobi,KK Union Olimpija,20,428,76,139,0.547,2,4,0.5,74,135,0.548,0.554,36,47,0.766,44,53,97,30,28,6,42,37,190
Tutku Acik,Fenerbahçe,19,334,29,65,0.446,16,42,0.381,13,23,0.565,0.569,15,23,0.652,2,17,19,30,21,1,17,31,89
Tyus Edney,Benetton Treviso,19,576,115,224,0.513,23,55,0.418,92,169,0.544,0.565,88,112,0.786,12,56,68,72,40,1,57,46,341
Valeri Daineko,Ural Great Perm,17,435,79,165,0.479,19,50,0.38,60,115,0.522,0.536,72,83,0.867,15,41,56,28,12,16,35,46,249
Vasco Evtimov,Skipper Fortitudo Bologna,11,173,34,62,0.548,0,0,,34,62,0.548,0.548,7,18,0.389,28,35,63,11,15,1,15,29,75
Vasileios Karasev,Ural Great Perm,19,578,64,135,0.474,21,57,0.368,43,78,0.551,0.552,62,79,0.785,7,27,34,60,22,3,41,73,211
Vassilis Kikilias,AEK Athens,17,156,7,24,0.292,4,17,0.235,3,7,0.429,0.375,2,9,0.222,9,18,27,10,4,0,8,32,20
Veljko Mrsic,Unicaja Malaga,13,317,53,121,0.438,16,46,0.348,37,75,0.493,0.504,39,48,0.813,19,32,51,18,5,1,23,19,161
Veselin Petrovic,Partizan,8,209,19,49,0.388,8,24,0.333,11,25,0.44,0.469,15,26,0.577,5,27,32,13,13,0,6,30,61
Vidas Ginevicius,BC Zalgiris,10,182,11,35,0.314,1,10,0.1,10,25,0.4,0.329,13,19,0.684,3,9,12,22,14,1,13,21,36
Virgil Stanescu,Opel Skyliners,14,344,52,106,0.491,5,12,0.417,47,94,0.5,0.514,35,45,0.778,31,53,84,6,17,4,20,49,144
Virginijus Praskevicius,BC Oostende,14,414,83,182,0.456,13,40,0.325,70,142,0.493,0.492,44,61,0.721,22,64,86,16,13,7,35,61,223
Virginius Sirvydis,Ural Great Perm,2,16,3,7,0.429,0,1,0,3,6,0.5,0.429,0,0,,0,0,0,1,0,0,2,3,6
Vladan Alanovic,Slask Wroclaw,6,75,4,10,0.4,1,3,0.333,3,7,0.429,0.45,5,8,0.625,1,3,4,9,4,0,8,11,14
Vladimir Anzulovic,KK Krka,8,96,10,31,0.323,6,20,0.3,4,11,0.364,0.419,6,6,1,0,5,5,12,0,0,7,19,33
Vladimir Boisa,KK Union Olimpija,8,66,6,21,0.286,1,7,0.143,5,14,0.357,0.31,9,10,0.9,3,6,9,0,3,0,2,20,22
Vladimir Krstic,Elan Bearnais Pau-Orthez,3,27,2,3,0.667,2,3,0.667,0,0,,1,2,2,1,1,2,3,3,1,0,2,5,8
Vladimir Kuzmanovic,KK Buducnost,14,375,42,100,0.42,19,50,0.38,23,50,0.46,0.515,18,24,0.75,10,19,29,29,15,1,27,46,121
Vlado Ilievski,KK Union Olimpija,20,360,32,64,0.5,13,30,0.433,19,34,0.559,0.602,16,21,0.762,6,23,29,29,25,1,10,38,93
Vlado Scepanovic,Partizan,14,468,80,163,0.491,45,89,0.506,35,74,0.473,0.629,71,88,0.807,8,19,27,25,13,2,32,32,276
Vujadin Subotic,KK Union Olimpija,3,25,1,6,0.167,0,5,0,1,1,1,0.167,2,2,1,0,1,1,1,2,0,0,3,4
Vule Avdalovic,Partizan,14,204,19,43,0.442,10,26,0.385,9,17,0.529,0.558,8,10,0.8,3,11,14,24,3,0,19,25,56
Vyacheslav Shushakov,Ural Great Perm,6,27,4,11,0.364,1,4,0.25,3,7,0.429,0.409,0,2,0,1,3,4,6,1,0,2,13,9
Wayne Henry,London Towers,5,64,6,15,0.4,0,4,0,6,11,0.545,0.4,1,2,0.5,4,4,8,2,4,0,5,10,13
Wendell Alexis,Alba Berlin,14,430,69,153,0.451,17,40,0.425,52,113,0.46,0.507,75,88,0.852,10,52,62,19,15,8,43,37,230
Willie Burton,Ural Great Perm,6,51,4,16,0.25,3,11,0.273,1,5,0.2,0.344,8,11,0.727,1,2,3,4,2,0,6,8,19
Yann Bonato,Adecco ASVEL Villeurbanne,13,320,39,91,0.429,8,24,0.333,31,67,0.463,0.473,41,48,0.854,19,27,46,22,10,1,19,42,127
Yoav Saffar,Maccabi Tel Aviv,16,162,23,53,0.434,1,15,0.067,22,38,0.579,0.443,13,19,0.684,9,19,28,9,6,1,14,27,60
Yotam Halperin,Maccabi Tel Aviv,3,6,0,2,0,0,1,0,0,1,0,0,0,0,,0,0,0,0,0,0,1,1,0
Zakhar Pashutin,CSKA Moscow,20,578,82,176,0.466,19,56,0.339,63,120,0.525,0.52,31,57,0.544,22,63,85,42,34,3,24,67,214
Zan Tabak,Real Madrid,18,396,70,111,0.631,0,0,,70,111,0.631,0.631,22,56,0.393,25,87,112,15,8,15,41,66,162
Zarko Cabarkapa,KK Buducnost,13,243,31,68,0.456,4,21,0.19,27,47,0.574,0.485,22,34,0.647,18,20,38,7,11,3,15,42,88
Zaza Pachulia,Fenerbahçe,13,100,15,29,0.517,0,1,0,15,28,0.536,0.517,11,15,0.733,14,10,24,2,4,1,5,13,41
Zoran Planinic,Cibona Zagreb,8,198,31,61,0.508,7,14,0.5,24,47,0.511,0.566,28,41,0.683,7,11,18,19,9,3,21,30,97
Zoran Savic,Skipper Fortitudo Bologna,19,321,62,118,0.525,19,53,0.358,43,65,0.662,0.606,32,51,0.627,13,40,53,18,11,1,33,58,175