Player,Team,G,MP,FG,FGA,FG%,3P,3PA,3P%,2P,2PA,2P%,eFG%,FT,FTA,FT%,ORB,DRB,TRB,AST,STL,BLK,TOV,PF,PTS
Aaron Craft,Buducnost VOLI,4,67,3,9,0.333,0,2,0,3,7,0.429,0.333,0,0,,4,3,7,9,2,0,5,10,6
Aaron White,Zalgiris,34,847,97,187,0.519,14,42,0.333,83,145,0.572,0.556,72,91,0.791,35,107,142,23,12,7,28,71,280
Adam Hanga,FC Barcelona Lassa,27,564,90,194,0.464,20,71,0.282,70,123,0.569,0.515,38,51,0.745,20,88,108,50,31,9,22,73,238
Adreian Payne,Panathinaikos OPAP,3,19,2,4,0.5,0,0,,2,4,0.5,0.5,2,4,0.5,2,6,8,0,0,0,3,6,6
Adrien Moerman,Anadolu Efes,37,1076,177,343,0.516,55,137,0.401,122,206,0.592,0.596,34,39,0.872,47,177,224,56,41,11,41,70,443
Ahmet Duverioglu,Fenerbahçe,31,346,41,66,0.621,0,0,,41,66,0.621,0.621,8,20,0.4,32,49,81,21,17,12,30,65,90
Ahmet Tuncer,Anadolu Efes,11,50,4,19,0.211,2,13,0.154,2,6,0.333,0.263,0,0,,1,6,7,10,5,0,5,6,10
Ajdin Penava,Kirolbet Baskonia,4,13,0,5,0,0,4,0,0,1,0,0,2,2,1,1,3,4,0,0,0,0,0,2
Albert Oliver,Herbalife Gran Canaria,28,409,36,111,0.324,16,48,0.333,20,63,0.317,0.396,26,29,0.897,14,23,37,93,9,1,38,43,114
Alec Peters,CSKA Moscow,36,586,63,150,0.42,39,90,0.433,24,60,0.4,0.55,25,28,0.893,24,72,96,26,17,3,22,85,190
Aleksa Ilic,Buducnost VOLI,3,45,6,13,0.462,0,0,,6,13,0.462,0.462,0,1,0,5,8,13,1,3,1,1,4,12
Aleksandar Vezenkov,Olympiacos,28,291,41,84,0.488,6,29,0.207,35,55,0.636,0.524,17,21,0.81,19,43,62,12,10,2,7,24,105
Aleksej Pokusevski,Olympiacos,2,6,0,3,0,0,1,0,0,2,0,0,1,2,0.5,1,1,2,1,1,0,1,1,1
Alen Omic,Buducnost VOLI,15,316,58,95,0.611,1,3,0.333,57,92,0.62,0.616,16,26,0.615,33,38,71,16,5,5,17,34,133
Alen Omic,AX Armani Exchange Olimpia,14,175,17,38,0.447,0,1,0,17,37,0.459,0.447,1,6,0.167,24,27,51,7,5,3,11,18,35
Alex King,Bayern Munich,14,40,3,10,0.3,2,9,0.222,1,1,1,0.4,0,3,0,5,1,6,3,1,0,1,4,8
Alex Tyus,Maccabi Tel Aviv,30,549,97,146,0.664,0,0,,97,146,0.664,0.664,25,40,0.625,39,85,124,8,14,34,22,53,219
Alexander Khomenko,CSKA Moscow,1,2,1,2,0.5,0,1,0,1,1,1,0.5,0,0,,0,0,0,0,0,0,0,0,2
Alexey Shved,BC Khimki,14,448,95,242,0.393,57,156,0.365,38,86,0.442,0.51,79,98,0.806,9,30,39,93,22,4,52,29,326
Amedeo Della Valle,AX Armani Exchange Olimpia,12,73,8,20,0.4,5,14,0.357,3,6,0.5,0.525,4,4,1,6,3,9,3,1,2,2,12,25
Andrea Cinciarini,AX Armani Exchange Olimpia,14,157,19,36,0.528,4,12,0.333,15,24,0.625,0.583,3,8,0.375,5,14,19,12,7,1,13,24,45
Andrei Lopatin,CSKA Moscow,1,5,0,0,,0,0,,0,0,,,0,0,,0,1,1,0,1,0,0,1,0
Andrew Harrison,BC Khimki,4,89,11,32,0.344,7,15,0.467,4,17,0.235,0.453,6,9,0.667,0,8,8,10,2,2,3,10,35
Andrey Vorontsevich,CSKA Moscow,19,191,12,46,0.261,10,33,0.303,2,13,0.154,0.37,8,8,1,9,21,30,13,5,4,6,20,42
Andrey Zubkov,BC Khimki,25,393,44,88,0.5,8,30,0.267,36,58,0.621,0.545,17,22,0.773,13,42,55,25,18,3,16,47,113
Andzejs Pasecniks,Herbalife Gran Canaria,22,371,64,132,0.485,1,7,0.143,63,125,0.504,0.489,29,52,0.558,41,38,79,9,11,9,14,55,158
Angelo Caloiaro,Maccabi Tel Aviv,30,744,78,163,0.479,23,73,0.315,55,90,0.611,0.549,42,53,0.792,60,85,145,41,37,3,24,73,221
Antanas Kavaliauskas,Zalgiris,20,236,40,68,0.588,0,0,,40,68,0.588,0.588,22,26,0.846,13,36,49,20,7,4,17,48,102
Ante Tomic,FC Barcelona Lassa,35,710,146,237,0.616,0,0,,146,237,0.616,0.616,60,98,0.612,70,106,176,61,19,12,57,82,352
Anthony Gill,BC Khimki,13,347,59,108,0.546,8,36,0.222,51,72,0.708,0.583,23,30,0.767,19,26,45,21,10,8,16,31,149
Anthony Randolph,Real Madrid,33,747,143,295,0.485,60,145,0.414,83,150,0.553,0.586,68,90,0.756,24,118,142,30,17,11,25,41,414
Artem Pustovyi,FC Barcelona Lassa,9,73,13,18,0.722,0,0,,13,18,0.722,0.722,8,13,0.615,9,6,15,1,2,4,3,9,34
Arturas Gudaitis,AX Armani Exchange Olimpia,21,500,78,122,0.639,0,0,,78,122,0.639,0.639,107,133,0.805,70,80,150,8,16,21,27,63,263
Arturas Milaknis,Zalgiris,34,786,75,186,0.403,60,144,0.417,15,42,0.357,0.565,29,34,0.853,11,38,49,30,22,2,23,57,239
Axel Toupane,Olympiacos,26,354,39,102,0.382,26,72,0.361,13,30,0.433,0.51,22,27,0.815,8,23,31,12,12,4,17,34,126
Berk Demir,Darüşşafaka,28,256,25,63,0.397,7,28,0.25,18,35,0.514,0.452,10,11,0.909,21,37,58,7,4,9,14,33,67
Bobby Dixon,Fenerbahçe,34,605,112,216,0.519,65,131,0.496,47,85,0.553,0.669,26,30,0.867,12,45,57,76,21,0,38,67,315
Brandon Davies,Zalgiris,34,823,176,315,0.559,0,0,,176,315,0.559,0.559,131,172,0.762,62,124,186,67,33,15,65,99,483
Braydon Hobbs,Bayern Munich,18,177,20,47,0.426,20,41,0.488,0,6,0,0.638,7,8,0.875,2,14,16,48,8,0,16,19,67
Briante Weber,Olympiacos,8,194,37,70,0.529,6,13,0.462,31,57,0.544,0.571,13,17,0.765,7,30,37,21,8,2,22,29,93
Brock Motum,Anadolu Efes,31,359,78,154,0.506,22,50,0.44,56,104,0.538,0.578,25,32,0.781,22,34,56,11,3,2,13,21,203
Bryant Dunston,Anadolu Efes,36,939,121,189,0.64,2,6,0.333,119,183,0.65,0.646,75,107,0.701,55,121,176,48,29,43,29,107,319
Charles Jenkins,BC Khimki,29,709,71,145,0.49,34,81,0.42,37,64,0.578,0.607,24,29,0.828,24,56,80,36,30,6,17,80,200
Chris Evans,Herbalife Gran Canaria,12,226,45,96,0.469,14,33,0.424,31,63,0.492,0.542,19,22,0.864,14,17,31,13,6,1,12,22,123
Chris Singleton,FC Barcelona Lassa,35,874,92,246,0.374,47,119,0.395,45,127,0.354,0.47,48,62,0.774,33,121,154,30,38,17,38,83,279
Christian Burns,AX Armani Exchange Olimpia,14,44,4,10,0.4,0,1,0,4,9,0.444,0.4,6,6,1,5,6,11,1,0,2,2,16,14
Clevin Hannah,Herbalife Gran Canaria,18,368,53,126,0.421,17,56,0.304,36,70,0.514,0.488,44,48,0.917,6,23,29,67,19,0,44,46,167
Cory Higgins,CSKA Moscow,32,814,156,317,0.492,51,104,0.49,105,213,0.493,0.573,113,126,0.897,18,52,70,58,13,8,43,80,476
Cory Jefferson,Herbalife Gran Canaria,5,63,7,22,0.318,3,12,0.25,4,10,0.4,0.386,0,1,0,5,7,12,1,0,1,1,7,17
Coty Clarke,Buducnost VOLI,29,636,76,167,0.455,15,36,0.417,61,131,0.466,0.5,30,38,0.789,29,95,124,31,27,5,27,77,197
Curtis Jerrells,AX Armani Exchange Olimpia,30,452,65,168,0.387,35,102,0.343,30,66,0.455,0.491,21,28,0.75,4,27,31,44,12,1,25,42,186
Dairis Bertans,AX Armani Exchange Olimpia,22,366,45,94,0.479,37,69,0.536,8,25,0.32,0.676,14,17,0.824,6,16,22,14,15,0,7,45,141
Daniel Hackett,CSKA Moscow,35,607,62,143,0.434,20,51,0.392,42,92,0.457,0.503,66,80,0.825,11,53,64,61,22,1,34,104,210
Danilo Barthel,Bayern Munich,30,712,91,179,0.508,19,47,0.404,72,132,0.545,0.561,43,61,0.705,30,90,120,56,10,7,39,69,244
Danilo Nikolic,Buducnost VOLI,26,370,52,106,0.491,24,59,0.407,28,47,0.596,0.604,12,20,0.6,25,36,61,10,7,7,10,34,140
Darrun Hilliard,Kirolbet Baskonia,34,697,106,257,0.412,39,121,0.322,67,136,0.493,0.488,69,89,0.775,9,88,97,38,23,2,43,91,320
Deandre Kane,Maccabi Tel Aviv,25,644,78,180,0.433,22,71,0.31,56,109,0.514,0.494,22,54,0.407,32,63,95,64,27,2,31,63,200
Dee Bost,BC Khimki,23,542,66,163,0.405,35,104,0.337,31,59,0.525,0.512,15,19,0.789,15,38,53,69,22,1,31,59,182
Deni Avdija,Maccabi Tel Aviv,8,51,12,27,0.444,5,10,0.5,7,17,0.412,0.537,2,2,1,4,8,12,2,1,0,1,7,31
Deon Thompson,Zalgiris,17,234,34,58,0.586,0,1,0,34,57,0.596,0.586,12,21,0.571,20,32,52,9,8,7,12,29,80
Derrick Williams,Bayern Munich,29,755,127,276,0.46,36,108,0.333,91,168,0.542,0.525,98,125,0.784,36,85,121,18,18,14,43,40,388
Deshaun Thomas,Panathinaikos OPAP,32,718,130,267,0.487,33,93,0.355,97,174,0.557,0.549,42,61,0.689,39,81,120,20,18,4,33,51,335
Devin Booker,Bayern Munich,16,329,63,114,0.553,6,16,0.375,57,98,0.582,0.579,11,18,0.611,22,32,54,24,10,5,20,32,143
Devin Williams,Buducnost VOLI,6,66,7,16,0.438,0,0,,7,16,0.438,0.438,6,9,0.667,2,13,15,3,1,0,2,10,20
Dimitrios Agravanis,Olympiacos,1,5,1,2,0.5,0,1,0,1,1,1,0.5,1,2,0.5,0,0,0,0,2,1,0,2,3
D.J. Strawberry,Herbalife Gran Canaria,29,631,84,229,0.367,35,108,0.324,49,121,0.405,0.443,45,64,0.703,11,42,53,56,24,4,44,48,248
Dogus Balbay,Anadolu Efes,37,387,29,58,0.5,14,23,0.609,15,35,0.429,0.621,1,1,1,19,33,52,49,16,7,14,67,73
Dogus Ozdemiroglu,Darüşşafaka,28,323,32,80,0.4,12,43,0.279,20,37,0.541,0.475,17,25,0.68,9,25,34,33,24,1,24,63,93
Donatas Sabeckis,Zalgiris,2,1,0,0,,0,0,,0,0,,,0,0,,0,0,0,0,0,0,0,0,0
Earl Clark,Buducnost VOLI,29,798,131,328,0.399,40,103,0.388,91,225,0.404,0.46,38,55,0.691,22,86,108,29,22,17,43,43,340
Edgaras Ulanovas,Zalgiris,34,849,79,180,0.439,23,65,0.354,56,115,0.487,0.503,63,75,0.84,39,75,114,46,19,6,40,65,244
Edwin Jackson,Buducnost VOLI,30,792,104,237,0.439,51,119,0.429,53,118,0.449,0.546,34,40,0.85,21,55,76,56,20,2,46,64,293
Efe Tirpanci,Fenerbahçe,1,1,0,0,,0,0,,0,0,,,0,0,,0,0,0,1,0,0,0,0,0
Egehan Arna,Fenerbahçe,3,10,0,2,0,0,1,0,0,1,0,0,0,0,,0,1,1,0,0,2,1,2,0
Egor Vyaltsev,BC Khimki,19,224,20,51,0.392,9,27,0.333,11,24,0.458,0.48,8,11,0.727,5,13,18,19,6,0,11,38,57
Emircan Kosut,Darüşşafaka,15,123,20,40,0.5,0,3,0,20,37,0.541,0.5,8,10,0.8,8,10,18,8,4,5,11,22,48
Erick Green,Fenerbahçe,28,353,60,114,0.526,20,49,0.408,40,65,0.615,0.614,16,17,0.941,2,20,22,21,11,2,6,29,156
Erikas Venskus,Zalgiris,2,13,2,4,0.5,0,0,,2,4,0.5,0.5,0,0,,1,1,2,3,1,0,1,0,4
Eulis Baez,Herbalife Gran Canaria,22,457,50,117,0.427,15,47,0.319,35,70,0.5,0.491,33,42,0.786,22,61,83,34,19,2,22,44,148
Fabien Causeur,Real Madrid,35,493,78,164,0.476,22,53,0.415,56,111,0.505,0.543,26,37,0.703,15,45,60,49,12,1,42,42,204
Facu Campazzo,Real Madrid,34,803,89,231,0.385,43,115,0.374,46,116,0.397,0.478,75,84,0.893,10,80,90,176,55,0,72,85,296
Fedor Zugic,Buducnost VOLI,1,1,0,0,,0,0,,0,0,,,0,0,,0,0,0,0,0,0,0,0,0
Felipe Reyes,Real Madrid,23,204,32,54,0.593,0,1,0,32,53,0.604,0.593,29,31,0.935,19,29,48,6,7,0,17,34,93
Filip Barovic,Buducnost VOLI,28,339,43,92,0.467,0,0,,43,92,0.467,0.467,35,57,0.614,28,42,70,18,12,8,24,64,121
Gabriel Deck,Real Madrid,31,456,50,84,0.595,6,18,0.333,44,66,0.667,0.631,30,43,0.698,26,47,73,21,6,1,23,31,136
Garlon Green,BC Khimki,11,163,18,48,0.375,5,19,0.263,13,29,0.448,0.427,6,8,0.75,3,10,13,3,5,2,8,16,47
Georgios Papagiannis,Panathinaikos OPAP,26,318,50,72,0.694,0,0,,50,72,0.694,0.694,5,9,0.556,27,47,74,5,7,15,20,40,105
Georgios Kalaitzakis,Panathinaikos OPAP,1,2,0,2,0,0,1,0,0,1,0,0,0,0,,0,0,0,0,0,0,0,0,0
Giorgos Bogris,Olympiacos,23,121,19,32,0.594,0,0,,19,32,0.594,0.594,2,5,0.4,10,8,18,6,7,1,9,32,40
Giorgos Printezis,Olympiacos,30,767,133,277,0.48,12,39,0.308,121,238,0.508,0.502,41,66,0.621,45,110,155,38,12,7,32,40,319
Goga Bitadze,Buducnost VOLI,13,315,51,93,0.548,5,16,0.313,46,77,0.597,0.575,50,70,0.714,33,50,83,15,6,30,18,47,157
Gustavo Ayon,Real Madrid,31,609,113,169,0.669,0,0,,113,169,0.669,0.669,32,59,0.542,42,144,186,90,24,24,40,70,258
Ian Vouyoukas,Panathinaikos OPAP,21,213,34,57,0.596,0,1,0,34,56,0.607,0.596,18,24,0.75,15,24,39,17,2,6,8,33,86
Ilimane Diop,Kirolbet Baskonia,33,379,40,81,0.494,3,13,0.231,37,68,0.544,0.512,46,59,0.78,35,49,84,18,9,17,21,79,129
Ioannis Papapetrou,Panathinaikos OPAP,28,714,95,189,0.503,25,75,0.333,70,114,0.614,0.569,37,55,0.673,28,90,118,31,22,15,24,58,252
Ivan Ukhov,CSKA Moscow,13,72,10,16,0.625,1,5,0.2,9,11,0.818,0.656,1,1,1,1,9,10,8,2,0,5,9,22
Jaka Blazic,FC Barcelona Lassa,25,342,40,86,0.465,12,31,0.387,28,55,0.509,0.535,38,47,0.809,20,37,57,15,9,3,13,34,130
Jake Cohen,Maccabi Tel Aviv,25,217,27,60,0.45,8,20,0.4,19,40,0.475,0.517,11,14,0.786,10,18,28,15,5,0,9,35,73
Jake Wiley,Herbalife Gran Canaria,7,151,31,50,0.62,0,1,0,31,49,0.633,0.62,8,10,0.8,9,9,18,4,6,7,13,17,70
Jalen Jones,Kirolbet Baskonia,13,129,20,47,0.426,6,18,0.333,14,29,0.483,0.489,12,17,0.706,12,13,25,2,4,2,8,20,58
James Anderson,Anadolu Efes,37,549,60,139,0.432,35,82,0.427,25,57,0.439,0.558,24,29,0.828,16,59,75,25,9,2,13,47,179
James Bell,Buducnost VOLI,16,310,25,72,0.347,17,51,0.333,8,21,0.381,0.465,8,8,1,7,28,35,8,7,3,15,47,75
James Birsen,Anadolu Efes,9,36,6,10,0.6,1,3,0.333,5,7,0.714,0.65,0,0,,1,3,4,3,0,1,1,3,13
James Gist,Panathinaikos OPAP,33,688,94,176,0.534,9,23,0.391,85,153,0.556,0.56,60,85,0.706,52,63,115,38,21,14,35,67,257
James Nunnally,AX Armani Exchange Olimpia,10,269,46,95,0.484,16,38,0.421,30,57,0.526,0.568,33,36,0.917,6,23,29,22,4,0,11,15,141
Jan Vesely,Fenerbahçe,31,778,136,209,0.651,1,5,0.2,135,204,0.662,0.653,107,136,0.787,49,97,146,73,43,17,56,88,380
Janis Strelnieks,Olympiacos,20,416,57,115,0.496,28,61,0.459,29,54,0.537,0.617,33,38,0.868,2,35,37,39,14,1,19,45,175
Janis Timma,Olympiacos,23,265,28,66,0.424,19,47,0.404,9,19,0.474,0.568,4,8,0.5,3,18,21,16,7,2,18,25,79
Jaycee Carroll,Real Madrid,31,501,99,224,0.442,37,108,0.343,62,116,0.534,0.525,48,50,0.96,14,19,33,16,7,2,13,56,283
Jayson Granger,Kirolbet Baskonia,12,231,30,81,0.37,17,42,0.405,13,39,0.333,0.475,9,14,0.643,1,18,19,29,4,0,16,21,86
Jeff Brooks,AX Armani Exchange Olimpia,29,729,68,136,0.5,19,48,0.396,49,88,0.557,0.57,20,24,0.833,42,111,153,29,22,8,24,60,175
Jeffery Taylor,Real Madrid,34,620,71,133,0.534,30,67,0.448,41,66,0.621,0.647,17,27,0.63,19,35,54,49,11,5,21,64,189
Jeremy Evans,Darüşşafaka,27,701,106,187,0.567,22,58,0.379,84,129,0.651,0.626,29,42,0.69,53,106,159,22,18,33,24,49,263
Jeremy Pargo,Maccabi Tel Aviv,11,211,19,80,0.238,8,37,0.216,11,43,0.256,0.288,14,24,0.583,2,17,19,30,3,1,19,21,60
Joel Bolomboy,CSKA Moscow,28,261,28,52,0.538,6,13,0.462,22,39,0.564,0.596,12,20,0.6,27,27,54,10,4,7,6,41,74
Joffrey Lauvergne,Fenerbahçe,22,396,81,145,0.559,6,20,0.3,75,125,0.6,0.579,19,37,0.514,29,50,79,40,8,7,19,32,187
Johannes Voigtmann,Kirolbet Baskonia,33,801,92,201,0.458,30,97,0.309,62,104,0.596,0.532,34,45,0.756,38,154,192,86,21,12,47,43,248
John DiBartolomeo,Maccabi Tel Aviv,29,298,44,122,0.361,32,93,0.344,12,29,0.414,0.492,17,21,0.81,16,24,40,33,12,1,7,44,137
Johnny O'Bryant,Maccabi Tel Aviv,30,702,119,303,0.393,37,121,0.306,82,182,0.451,0.454,44,56,0.786,30,146,176,39,14,10,60,78,319
Jon Diebler,Darüşşafaka,28,511,40,111,0.36,29,80,0.363,11,31,0.355,0.491,12,13,0.923,7,30,37,34,10,2,18,45,121
Jordan Mickey,BC Khimki,28,631,155,293,0.529,20,57,0.351,135,236,0.572,0.563,68,92,0.739,47,92,139,20,21,30,42,53,398
Josh Magette,Herbalife Gran Canaria,6,107,4,30,0.133,3,15,0.2,1,15,0.067,0.183,2,4,0.5,1,4,5,29,3,0,10,13,13
Jovan Kljajic,Herbalife Gran Canaria,1,3,1,2,0.5,0,1,0,1,1,1,0.5,0,0,,0,0,0,0,0,0,0,0,2
Kaleb Tarczewski,AX Armani Exchange Olimpia,24,436,63,87,0.724,0,0,,63,87,0.724,0.724,27,39,0.692,51,59,110,9,10,16,24,67,153
Kartal Ozmizrak,Darüşşafaka,23,364,44,110,0.4,21,59,0.356,23,51,0.451,0.495,24,31,0.774,5,30,35,54,8,1,19,39,133
Keith Langford,Panathinaikos OPAP,25,497,91,213,0.427,25,64,0.391,66,149,0.443,0.486,60,74,0.811,8,47,55,28,17,5,22,47,267
Kendrick Ray,Maccabi Tel Aviv,17,188,28,64,0.438,11,24,0.458,17,40,0.425,0.523,14,21,0.667,1,13,14,19,3,2,15,29,81
Kevin Pangos,FC Barcelona Lassa,35,712,85,220,0.386,33,104,0.317,52,116,0.448,0.461,43,58,0.741,6,34,40,111,15,0,53,70,246
Kevin Seraphin,FC Barcelona Lassa,27,380,96,152,0.632,0,0,,96,152,0.632,0.632,33,42,0.786,37,59,96,13,6,10,45,72,225
Khalifa Diop,Herbalife Gran Canaria,1,7,1,2,0.5,0,0,,1,2,0.5,0.5,1,2,0.5,2,2,4,0,1,0,0,0,3
Kim Tillie,Herbalife Gran Canaria,29,494,69,151,0.457,36,88,0.409,33,63,0.524,0.576,15,24,0.625,28,49,77,19,17,5,29,54,189
Klemen Prepelic,Real Madrid,21,191,26,68,0.382,11,39,0.282,15,29,0.517,0.463,17,23,0.739,3,16,19,35,3,1,13,28,80
Dinos Mitoglou,Panathinaikos OPAP,27,372,49,96,0.51,5,25,0.2,44,71,0.62,0.536,11,20,0.55,39,41,80,8,8,4,17,51,114
Kostas Papanikolaou,Olympiacos,30,703,69,160,0.431,39,105,0.371,30,55,0.545,0.553,31,42,0.738,18,100,118,49,23,9,44,50,208
Kostas Sloukas,Fenerbahçe,33,879,128,245,0.522,48,107,0.449,80,138,0.58,0.62,85,91,0.934,12,60,72,157,18,1,62,51,389
Krunoslav Simon,Anadolu Efes,37,917,117,242,0.483,56,139,0.403,61,103,0.592,0.599,59,70,0.843,22,117,139,102,33,7,49,73,349
Kyle Hines,CSKA Moscow,36,704,105,181,0.58,0,0,,105,181,0.58,0.58,53,84,0.631,66,64,130,49,24,26,35,92,263
Kyle Kuric,FC Barcelona Lassa,34,671,99,224,0.442,54,136,0.397,45,88,0.511,0.563,32,37,0.865,24,49,73,28,27,2,22,45,284
Laurynas Birutis,Zalgiris,17,118,17,29,0.586,0,0,,17,29,0.586,0.586,12,17,0.706,8,7,15,2,2,5,11,20,46
Leo Westermann,Zalgiris,27,466,53,133,0.398,37,88,0.42,16,45,0.356,0.538,29,39,0.744,8,46,54,76,15,0,55,56,172
Leon Radosevic,Bayern Munich,29,446,59,106,0.557,0,1,0,59,105,0.562,0.557,16,24,0.667,23,36,59,27,9,11,28,52,134
Luca Vildoza,Kirolbet Baskonia,34,766,102,253,0.403,54,145,0.372,48,108,0.444,0.51,51,58,0.879,13,64,77,128,36,5,57,79,309
Luigi Datome,Fenerbahçe,34,718,106,222,0.477,49,118,0.415,57,104,0.548,0.588,44,48,0.917,23,98,121,26,17,8,34,82,305
Lukas Lekavicius,Panathinaikos OPAP,33,358,47,111,0.423,17,42,0.405,30,69,0.435,0.5,22,28,0.786,7,20,27,44,9,1,26,40,133
Lukas Uleckas,Zalgiris,4,25,2,7,0.286,0,4,0,2,3,0.667,0.286,0,0,,0,3,3,4,1,1,3,2,4
Luke Fischer,Herbalife Gran Canaria,13,109,19,30,0.633,0,0,,19,30,0.633,0.633,9,21,0.429,13,13,26,2,2,2,5,21,47
Malcolm Thomas,BC Khimki,30,618,102,173,0.59,12,38,0.316,90,135,0.667,0.624,41,61,0.672,59,92,151,52,25,17,36,68,257
Maodo Lo,Bayern Munich,29,530,69,155,0.445,22,64,0.344,47,91,0.516,0.516,33,42,0.786,7,36,43,55,28,2,37,56,193
Marcelo Huertas,Kirolbet Baskonia,34,664,101,204,0.495,24,57,0.421,77,147,0.524,0.554,38,43,0.884,17,35,52,160,23,0,84,62,264
Marcus Eriksson,Herbalife Gran Canaria,29,541,105,237,0.443,61,147,0.415,44,90,0.489,0.572,31,33,0.939,7,32,39,24,18,0,17,28,302
Marius Grigonis,Zalgiris,34,706,88,189,0.466,34,77,0.442,54,112,0.482,0.556,86,92,0.935,10,63,73,66,20,0,46,87,296
Markel Brown,Darüşşafaka,20,349,34,98,0.347,14,54,0.259,20,44,0.455,0.418,15,23,0.652,11,22,33,38,7,4,16,25,97
Marko Guduric,Fenerbahçe,36,796,113,206,0.549,52,109,0.477,61,97,0.629,0.675,59,70,0.843,15,55,70,79,33,8,45,75,337
Marvin Ogunsipe,Bayern Munich,10,62,4,11,0.364,0,3,0,4,8,0.5,0.364,1,2,0.5,2,5,7,1,2,0,4,13,9
Matt Janning,Kirolbet Baskonia,28,699,95,230,0.413,63,167,0.377,32,63,0.508,0.55,31,39,0.795,13,47,60,49,23,3,29,51,284
Matt Lojeski,Olympiacos,2,41,4,11,0.364,0,4,0,4,7,0.571,0.364,2,2,1,1,5,6,3,1,0,1,2,10
Matt Lojeski,Panathinaikos OPAP,23,356,58,107,0.542,16,41,0.39,42,66,0.636,0.617,21,23,0.913,12,37,49,19,3,2,14,34,153
Melih Mahmutoglu,Fenerbahçe,31,374,60,118,0.508,35,76,0.461,25,42,0.595,0.657,19,20,0.95,3,23,26,17,5,1,5,45,174
Melwin Pantzar,Real Madrid,1,9,1,3,0.333,1,2,0.5,0,1,0,0.5,0,0,,0,0,0,1,0,0,1,0,3
Mert Akay,Darüşşafaka,7,77,7,17,0.412,2,8,0.25,5,9,0.556,0.471,5,9,0.556,3,5,8,11,3,0,8,17,21
Michael Eric,Darüşşafaka,29,589,129,239,0.54,0,0,,129,239,0.54,0.54,63,96,0.656,65,81,146,25,8,25,65,80,321
Michael Roll,Maccabi Tel Aviv,29,624,105,222,0.473,35,86,0.407,70,136,0.515,0.552,19,21,0.905,20,43,63,79,20,1,33,55,264
Miguel Gonzalez,Kirolbet Baskonia,6,6,0,1,0,0,1,0,0,0,,0,0,0,,0,0,0,0,1,0,1,0,0
Mike James,AX Armani Exchange Olimpia,30,1018,189,468,0.404,70,215,0.326,119,253,0.47,0.479,147,178,0.826,12,102,114,191,39,1,77,77,595
Mikhail Kulagin,CSKA Moscow,9,52,5,17,0.294,4,12,0.333,1,5,0.2,0.412,2,2,1,0,0,0,6,0,0,5,9,16
Mindaugas Kuzminskas,AX Armani Exchange Olimpia,30,512,85,171,0.497,30,64,0.469,55,107,0.514,0.585,55,64,0.859,38,60,98,22,16,4,28,52,255
Muhammed Baygul,Darüşşafaka,22,296,34,87,0.391,10,29,0.345,24,58,0.414,0.448,23,28,0.821,15,28,43,21,7,0,27,38,101
Nando De Colo,CSKA Moscow,34,824,160,320,0.5,59,137,0.431,101,183,0.552,0.592,122,129,0.946,16,68,84,116,32,0,70,60,501
Nate Wolters,Zalgiris,28,641,132,258,0.512,25,68,0.368,107,190,0.563,0.56,25,36,0.694,8,71,79,106,23,0,41,61,314
Nemanja Dangubic,Bayern Munich,30,445,40,97,0.412,17,43,0.395,23,54,0.426,0.5,28,37,0.757,11,61,72,14,10,4,13,56,125
Nemanja Gordic,Buducnost VOLI,30,700,87,225,0.387,24,79,0.304,63,146,0.432,0.44,30,42,0.714,9,42,51,108,19,0,53,68,228
Nemanja Nedovic,AX Armani Exchange Olimpia,15,352,59,128,0.461,29,70,0.414,30,58,0.517,0.574,25,31,0.806,8,29,37,40,12,2,32,37,172
Nick Calathes,Panathinaikos OPAP,33,1022,163,415,0.393,39,147,0.265,124,268,0.463,0.44,38,72,0.528,17,126,143,286,57,2,102,86,403
Nicolo Melli,Fenerbahçe,36,934,93,214,0.435,37,96,0.385,56,118,0.475,0.521,40,49,0.816,40,106,146,58,34,20,36,104,263
Nigel Williams-Goss,Olympiacos,30,788,102,252,0.405,30,81,0.37,72,171,0.421,0.464,43,52,0.827,12,49,61,125,21,1,43,65,277
Nihad Dedovic,Bayern Munich,30,690,107,231,0.463,32,97,0.33,75,134,0.56,0.532,51,61,0.836,19,55,74,80,29,1,34,69,297
Nikita Kurbanov,CSKA Moscow,34,604,65,109,0.596,24,47,0.511,41,62,0.661,0.706,40,48,0.833,35,85,120,27,18,7,26,68,194
Nikola Ivanovic,Buducnost VOLI,8,157,19,50,0.38,9,27,0.333,10,23,0.435,0.47,9,11,0.818,7,8,15,29,7,0,7,14,56
Nikola Kalinic,Fenerbahçe,35,891,120,248,0.484,35,88,0.398,85,160,0.531,0.554,62,79,0.785,31,83,114,62,25,6,39,76,337
Nikola Milutinov,Olympiacos,28,729,126,190,0.663,1,1,1,125,189,0.661,0.666,74,101,0.733,95,125,220,42,17,20,36,41,327
Nikola Radicevic,Herbalife Gran Canaria,14,237,25,59,0.424,6,23,0.261,19,36,0.528,0.475,18,20,0.9,4,18,22,55,4,0,25,35,74
Nikos Pappas,Panathinaikos OPAP,19,341,38,111,0.342,16,59,0.271,22,52,0.423,0.414,38,46,0.826,3,16,19,22,16,0,15,48,130
Nimrod Levi,Maccabi Tel Aviv,5,11,1,2,0.5,1,1,1,0,1,0,0.75,0,0,,0,1,1,0,0,0,0,1,3
Norris Cole,Buducnost VOLI,15,400,100,203,0.493,19,50,0.38,81,153,0.529,0.539,30,35,0.857,7,33,40,69,12,0,47,40,249
Ognjen Kuzmic,Real Madrid,5,34,4,11,0.364,0,0,,4,11,0.364,0.364,3,5,0.6,8,5,13,0,1,2,4,8,11
Oguz Savas,Darüşşafaka,27,364,58,121,0.479,0,0,,58,121,0.479,0.479,25,36,0.694,29,42,71,21,7,7,22,44,141
Olek Balcerowski,Herbalife Gran Canaria,6,74,7,16,0.438,4,10,0.4,3,6,0.5,0.563,0,0,,2,8,10,2,2,2,1,8,18
Ondrej Balvin,Herbalife Gran Canaria,29,540,81,126,0.643,0,0,,81,126,0.643,0.643,29,48,0.604,50,98,148,26,10,13,34,68,191
Oriol Pauli,Herbalife Gran Canaria,29,408,57,127,0.449,6,42,0.143,51,85,0.6,0.472,32,51,0.627,11,54,65,41,9,5,35,38,152
Othello Hunter,CSKA Moscow,36,645,118,198,0.596,0,0,,118,198,0.596,0.596,40,55,0.727,68,87,155,31,19,15,27,84,276
Patricio Garino,Kirolbet Baskonia,18,265,35,69,0.507,16,36,0.444,19,33,0.576,0.623,14,19,0.737,11,14,25,6,13,2,5,39,100
Pau Ribas,FC Barcelona Lassa,26,453,46,131,0.351,33,87,0.379,13,44,0.295,0.477,12,15,0.8,7,42,49,56,19,0,28,36,137
Paulius Jankunas,Zalgiris,17,273,36,72,0.5,1,4,0.25,35,68,0.515,0.507,33,37,0.892,10,42,52,16,3,4,17,33,106
Petar Popovic,Buducnost VOLI,21,285,38,83,0.458,11,24,0.458,27,59,0.458,0.524,15,20,0.75,5,14,19,25,10,1,15,33,102
Petr Gubanov,BC Khimki,12,112,4,14,0.286,2,8,0.25,2,6,0.333,0.357,5,8,0.625,2,5,7,4,3,1,2,18,15
Petteri Koponen,Bayern Munich,30,549,98,190,0.516,51,109,0.468,47,81,0.58,0.65,24,26,0.923,8,39,47,57,9,1,28,40,271
Pierre Oriola,FC Barcelona Lassa,35,603,71,151,0.47,14,46,0.304,57,105,0.543,0.517,38,62,0.613,47,76,123,24,10,10,22,74,194
Ramon Sessions,Maccabi Tel Aviv,2,40,6,20,0.3,1,6,0.167,5,14,0.357,0.325,5,6,0.833,3,4,7,2,1,0,3,2,18
Ray McCallum,Darüşşafaka,16,353,61,155,0.394,10,35,0.286,51,120,0.425,0.426,19,28,0.679,14,45,59,65,14,3,36,29,151
Robin Amaize,Bayern Munich,15,63,4,11,0.364,3,7,0.429,1,4,0.25,0.5,1,2,0.5,1,2,3,4,2,0,3,18,12
Rodrigue Beaubois,Anadolu Efes,35,718,123,278,0.442,56,140,0.4,67,138,0.486,0.543,31,34,0.912,6,40,46,80,10,12,37,57,333
Rokas Jokubaitis,Zalgiris,12,70,11,22,0.5,1,5,0.2,10,17,0.588,0.523,8,10,0.8,2,4,6,7,0,1,12,8,31
Rolands Smits,FC Barcelona Lassa,14,162,21,54,0.389,10,27,0.37,11,27,0.407,0.481,10,11,0.909,8,20,28,8,5,3,9,22,62
Rudy Fernandez,Real Madrid,31,634,85,208,0.409,65,157,0.414,20,51,0.392,0.565,44,54,0.815,20,66,86,83,24,5,25,46,279
Santiago Yusta,Real Madrid,6,46,7,15,0.467,3,7,0.429,4,8,0.5,0.567,5,8,0.625,2,3,5,3,1,0,3,9,22
Scottie Wilbekin,Maccabi Tel Aviv,29,719,126,317,0.397,65,198,0.328,61,119,0.513,0.5,56,70,0.8,10,43,53,90,26,0,48,54,373
Sead Sehovic,Buducnost VOLI,7,59,7,13,0.538,0,3,0,7,10,0.7,0.538,0,0,,6,4,10,5,1,0,5,4,14
Sean Kilpatrick,Panathinaikos OPAP,15,317,54,125,0.432,16,48,0.333,38,77,0.494,0.496,14,15,0.933,3,22,25,16,13,2,11,25,138
Semen Antonov,CSKA Moscow,21,150,11,34,0.324,2,15,0.133,9,19,0.474,0.353,5,9,0.556,12,10,22,3,2,2,0,26,29
Sergei Monia,BC Khimki,26,320,38,90,0.422,29,65,0.446,9,25,0.36,0.583,2,3,0.667,20,28,48,26,13,9,18,47,107
Sergio Llull,Real Madrid,27,577,92,257,0.358,53,165,0.321,39,92,0.424,0.461,46,48,0.958,3,50,53,107,12,0,32,51,283
Sergio Rodriguez,CSKA Moscow,35,765,127,302,0.421,67,171,0.392,60,131,0.458,0.531,36,41,0.878,9,44,53,159,24,2,76,74,357
Sertac Sanli,Anadolu Efes,9,32,7,9,0.778,0,1,0,7,8,0.875,0.778,4,5,0.8,2,2,4,0,0,0,1,5,18
Shane Larkin,Anadolu Efes,35,769,138,277,0.498,66,147,0.449,72,130,0.554,0.617,97,112,0.866,12,65,77,110,30,3,64,55,439
Shavon Shields,Kirolbet Baskonia,33,807,122,243,0.502,26,73,0.356,96,170,0.565,0.556,53,60,0.883,37,56,93,37,19,2,34,67,323
Siim Sander Vene,Herbalife Gran Canaria,18,271,43,90,0.478,21,54,0.389,22,36,0.611,0.594,16,19,0.842,6,16,22,10,9,0,6,34,123
Simone Fontecchio,AX Armani Exchange Olimpia,5,4,0,2,0,0,2,0,0,0,,0,0,0,,0,0,0,0,0,0,0,4,0
Sinan Guler,Fenerbahçe,20,116,14,31,0.452,0,9,0,14,22,0.636,0.452,1,2,0.5,0,5,5,16,11,1,6,18,29
Stanton Kidd,Darüşşafaka,30,653,77,197,0.391,27,95,0.284,50,102,0.49,0.459,24,35,0.686,18,73,91,36,18,7,29,63,205
Stefan Jovic,Bayern Munich,23,494,76,149,0.51,18,45,0.4,58,104,0.558,0.57,20,27,0.741,15,40,55,105,29,1,41,49,190
Stefan Markovic,BC Khimki,27,642,52,134,0.388,30,86,0.349,22,48,0.458,0.5,30,40,0.75,14,44,58,120,21,0,41,66,164
Stephane Lasme,Panathinaikos OPAP,18,291,35,66,0.53,2,2,1,33,64,0.516,0.545,19,28,0.679,18,33,51,7,10,14,15,51,91
Suad Sehovic,Buducnost VOLI,22,312,27,59,0.458,23,55,0.418,4,4,1,0.653,5,5,1,7,34,41,10,8,2,2,47,82
Tadas Sedekerskis,Kirolbet Baskonia,2,6,2,3,0.667,0,0,,2,3,0.667,0.667,0,0,,1,1,2,0,0,0,0,0,4
Tarik Biberovic,Fenerbahçe,8,47,7,20,0.35,1,8,0.125,6,12,0.5,0.375,3,6,0.5,2,10,12,1,1,0,3,2,18
Tarik Black,Maccabi Tel Aviv,26,559,116,167,0.695,0,1,0,116,166,0.699,0.695,54,79,0.684,56,85,141,18,12,20,37,75,286
Thanasis Antetokounmpo,Panathinaikos OPAP,29,350,51,86,0.593,7,22,0.318,44,64,0.688,0.634,13,29,0.448,19,32,51,9,22,9,14,68,122
Thomas Heurtel,FC Barcelona Lassa,35,739,137,287,0.477,36,80,0.45,101,207,0.488,0.54,55,73,0.753,9,57,66,167,23,0,81,48,365
Thomas Walkup,Zalgiris,34,572,69,142,0.486,13,44,0.295,56,98,0.571,0.532,25,31,0.806,18,71,89,75,18,1,40,90,176
Tibor Pleiss,Anadolu Efes,37,526,127,204,0.623,10,30,0.333,117,174,0.672,0.647,36,41,0.878,42,96,138,14,14,19,31,58,300
Timofey Yakushin,BC Khimki,1,0,0,0,,0,0,,0,0,,,0,0,,0,0,0,0,0,0,0,0,0
Toney Douglas,Darüşşafaka,20,551,103,251,0.41,37,112,0.33,66,139,0.475,0.484,47,53,0.887,19,47,66,80,33,3,46,55,290
Tony Crocker,BC Khimki,30,688,91,239,0.381,44,136,0.324,47,103,0.456,0.473,42,45,0.933,19,51,70,41,24,2,39,88,268
Tornike Shengelia,Kirolbet Baskonia,20,490,82,163,0.503,11,28,0.393,71,135,0.526,0.537,54,102,0.529,25,60,85,33,23,8,34,52,229
Trey Thompkins,Real Madrid,24,417,75,154,0.487,29,74,0.392,46,80,0.575,0.581,23,26,0.885,11,75,86,16,11,2,22,35,202
Tyler Ennis,Fenerbahçe,3,31,7,9,0.778,1,1,1,6,8,0.75,0.833,4,6,0.667,0,2,2,3,1,0,3,3,19
Vangelis Mantzaris,Olympiacos,27,322,13,48,0.271,8,38,0.211,5,10,0.5,0.354,3,6,0.5,9,35,44,33,7,1,16,38,37
Vasilije Micic,Anadolu Efes,37,1044,167,352,0.474,66,178,0.371,101,174,0.58,0.568,59,72,0.819,9,72,81,203,38,2,105,100,459
Vassilis Spanoulis,Olympiacos,25,552,84,220,0.382,40,121,0.331,44,99,0.444,0.473,47,66,0.712,10,36,46,127,11,1,72,58,255
Vyacheslav Zaytsev,BC Khimki,15,97,9,21,0.429,1,3,0.333,8,18,0.444,0.452,8,12,0.667,5,3,8,8,6,5,4,22,27
Victor Claver,FC Barcelona Lassa,35,744,61,128,0.477,19,56,0.339,42,72,0.583,0.551,46,56,0.821,30,81,111,35,21,13,28,59,187
Vincent Poirier,Kirolbet Baskonia,34,872,169,274,0.617,0,0,,169,274,0.617,0.617,68,93,0.731,117,165,282,37,27,28,44,89,406
Vladimir Lucic,Bayern Munich,29,759,104,199,0.523,26,74,0.351,78,125,0.624,0.588,57,69,0.826,22,89,111,35,32,5,20,69,291
Vladimir Micov,AX Armani Exchange Olimpia,30,939,149,327,0.456,56,142,0.394,93,185,0.503,0.541,64,81,0.79,18,79,97,76,34,4,42,69,418
Walter Tavares,Real Madrid,34,659,104,131,0.794,0,0,,104,131,0.794,0.794,43,68,0.632,74,138,212,23,14,57,42,77,251
Will Clyburn,CSKA Moscow,35,945,162,342,0.474,34,99,0.343,128,243,0.527,0.523,117,157,0.745,59,179,238,51,36,6,49,66,475
Xavi Rabaseda,Herbalife Gran Canaria,28,559,60,147,0.408,27,84,0.321,33,63,0.524,0.5,26,34,0.765,16,49,65,35,33,8,33,58,173
Yovel Zoosman,Maccabi Tel Aviv,30,443,34,74,0.459,12,32,0.375,22,42,0.524,0.541,11,13,0.846,15,45,60,35,20,7,23,48,91
Zach LeDay,Olympiacos,30,513,100,186,0.538,10,28,0.357,90,158,0.57,0.565,82,105,0.781,55,66,121,8,10,12,26,53,292
Zanis Peiners,Darüşşafaka,28,491,60,112,0.536,9,30,0.3,51,82,0.622,0.576,57,66,0.864,15,37,52,43,12,6,36,41,186
Zoran Nikolic,Buducnost VOLI,4,31,2,5,0.4,0,0,,2,5,0.4,0.4,1,4,0.25,5,3,8,0,4,0,2,11,5