Player,Team,G,MP,FG,FGA,FG%,3P,3PA,3P%,2P,2PA,2P%,eFG%,FT,FTA,FT%,ORB,DRB,TRB,AST,STL,BLK,TOV,PF,PTS
Aaron Jackson,CSKA Moscow,28,608,77,142,0.542,20,49,0.408,57,93,0.613,0.613,27,35,0.771,17,50,67,87,26,1,29,39,201
Adrien Moerman,Limoges CSP,10,270,35,84,0.417,9,38,0.237,26,46,0.565,0.47,13,15,0.867,15,54,69,12,8,2,15,19,92
A.J. Slaughter,Panathinaikos,23,524,80,206,0.388,40,109,0.367,40,97,0.412,0.485,24,30,0.8,6,40,46,39,10,1,27,56,224
Akeem Vargas,Alba Berlin,24,324,14,52,0.269,11,34,0.324,3,18,0.167,0.375,4,8,0.5,2,28,30,13,13,1,9,65,43
Aleks Maric,Maccabi Tel Aviv,8,70,8,14,0.571,0,0,,8,14,0.571,0.571,2,2,1,4,14,18,4,1,3,3,9,18
Aleks Maric,Galatasaray,7,70,5,13,0.385,0,0,,5,13,0.385,0.385,2,4,0.5,7,13,20,5,1,0,7,10,12
Aleksey Zozulin,CSKA Moscow,6,32,4,5,0.8,3,4,0.75,1,1,1,1.1,1,2,0.5,3,4,7,1,0,1,0,4,12
Alessandro Gentile,EA7-Emporio Armani Milano,20,549,97,226,0.429,19,62,0.306,78,164,0.476,0.471,73,94,0.777,17,44,61,50,13,0,38,54,286
Alex Abrines,FC Barcelona,23,417,59,131,0.45,29,85,0.341,30,46,0.652,0.561,27,35,0.771,8,27,35,31,15,4,14,50,174
Alex King,Alba Berlin,24,441,35,102,0.343,19,69,0.275,16,33,0.485,0.436,6,13,0.462,22,34,56,11,10,1,18,43,95
Alex Renfroe,Alba Berlin,24,635,80,167,0.479,32,70,0.457,48,97,0.495,0.575,42,51,0.824,33,75,108,128,33,2,61,59,234
Alex Tyus,Maccabi Tel Aviv,25,527,77,126,0.611,0,0,,77,126,0.611,0.611,27,51,0.529,51,79,130,10,9,35,20,42,181
Andreas Christodoulou,Olympiacos,1,1,0,0,,0,0,,0,0,,,0,0,,0,0,0,0,0,0,0,0,0
Andrei Kirilenko,CSKA Moscow,11,212,29,56,0.518,6,13,0.462,23,43,0.535,0.571,30,44,0.682,13,45,58,13,12,13,9,23,94
Andres Nocioni,Real Madrid,29,514,89,193,0.461,34,91,0.374,55,102,0.539,0.549,39,49,0.796,21,91,112,15,7,10,25,72,251
Andrew Goudelock,Fenerbahçe,29,865,193,378,0.511,71,154,0.461,122,224,0.545,0.604,36,48,0.75,10,54,64,61,20,3,43,51,493
Andrey Vorontsevich,CSKA Moscow,30,771,92,206,0.447,37,100,0.37,55,106,0.519,0.536,30,39,0.769,48,123,171,65,19,27,27,59,251
Angelo Gigli,EA7-Emporio Armani Milano,4,24,2,3,0.667,0,0,,2,3,0.667,0.667,2,4,0.5,3,3,6,2,0,0,0,6,6
Ante Delas,Cedevita Zagreb,8,100,10,28,0.357,7,18,0.389,3,10,0.3,0.482,7,7,1,1,4,5,6,5,0,3,12,34
Ante Tomic,FC Barcelona,28,678,117,192,0.609,0,0,,117,192,0.609,0.609,88,128,0.688,55,145,200,65,16,21,43,64,322
Anton Astapkovich,CSKA Moscow,3,16,2,6,0.333,1,5,0.2,1,1,1,0.417,0,0,,0,2,2,4,0,0,1,1,5
Anton Gavel,FC Bayern Munich,7,203,17,46,0.37,5,18,0.278,12,28,0.429,0.424,18,20,0.9,3,12,15,23,2,0,2,14,57
Antonios Koniaris,Panathinaikos,1,1,0,0,,0,0,,0,0,,,0,0,,0,1,1,0,0,0,0,0,0
Antonis Fotsis,Panathinaikos,27,635,71,126,0.563,43,85,0.506,28,41,0.683,0.734,22,30,0.733,34,78,112,22,12,5,15,47,207
Arad Harari,Maccabi Tel Aviv,1,1,0,0,,0,0,,0,0,,,0,0,,0,0,0,0,0,0,0,0,0
Arnas Butkevicius,Neptunas Klaipeda,10,205,24,43,0.558,8,17,0.471,16,26,0.615,0.651,14,27,0.519,7,21,28,11,9,5,14,22,70
Artsiom Parakhouski,Nizhny Novgorod,23,579,118,192,0.615,0,2,0,118,190,0.621,0.615,62,90,0.689,47,106,153,18,15,45,31,44,298
Arturas Gudaitis,BC Zalgiris,20,307,43,85,0.506,2,5,0.4,41,80,0.513,0.518,42,68,0.618,37,43,80,5,3,18,15,41,130
Arturas Milaknis,BC Zalgiris,24,621,79,171,0.462,60,130,0.462,19,41,0.463,0.637,21,27,0.778,8,35,43,33,8,2,24,52,239
Ben Altit,Maccabi Tel Aviv,1,0,0,0,,0,0,,0,0,,,0,0,,0,0,0,0,0,0,0,0,0
Ben Hansbrough,Laboral Kutxa,12,149,10,31,0.323,6,22,0.273,4,9,0.444,0.419,1,2,0.5,5,12,17,10,5,0,7,28,27
Berk Ugurlu,Fenerbahçe,3,16,1,5,0.2,0,1,0,1,4,0.25,0.2,0,1,0,0,0,0,0,1,0,2,1,2
Birkan Batuk,Anadolu Efes,9,90,13,27,0.481,8,16,0.5,5,11,0.455,0.63,3,4,0.75,2,5,7,1,2,0,1,21,37
Bo McCalebb,FC Bayern Munich,5,117,17,49,0.347,5,14,0.357,12,35,0.343,0.398,10,12,0.833,8,4,12,18,3,0,10,15,49
Boban Marjanovic,Crvena zvezda / Red Star,24,655,149,240,0.621,0,0,,149,240,0.621,0.621,100,128,0.781,83,173,256,24,9,21,33,36,398
Bogdan Bogdanovic,Fenerbahçe,29,821,105,266,0.395,49,137,0.358,56,129,0.434,0.487,47,59,0.797,13,72,85,80,21,10,43,57,306
Bojan Dubljevic,Valencia Basket,8,183,45,88,0.511,12,28,0.429,33,60,0.55,0.58,22,24,0.917,10,23,33,7,7,2,8,18,124
Bostjan Nachbar,FC Barcelona,25,305,46,88,0.523,24,53,0.453,22,35,0.629,0.659,12,13,0.923,5,46,51,14,6,2,8,50,128
Brad Oleson,FC Barcelona,20,381,44,105,0.419,26,66,0.394,18,39,0.462,0.543,17,18,0.944,6,23,29,47,14,3,20,30,131
Branko Lazic,Crvena zvezda / Red Star,19,338,26,66,0.394,10,29,0.345,16,37,0.432,0.47,12,16,0.75,13,16,29,14,11,1,13,39,74
Brent Petway,Olympiacos,24,438,45,107,0.421,24,73,0.329,21,34,0.618,0.533,18,23,0.783,20,68,88,23,9,20,13,56,132
Brian Randle,Maccabi Tel Aviv,25,718,128,215,0.595,6,25,0.24,122,190,0.642,0.609,38,58,0.655,48,91,139,50,38,31,35,84,300
Brian Sacchetti,Banco di Sardegna Sassari,8,105,6,18,0.333,5,15,0.333,1,3,0.333,0.472,2,2,1,8,13,21,11,5,0,4,11,19
Bruno Cerella,EA7-Emporio Armani Milano,19,179,16,34,0.471,3,9,0.333,13,25,0.52,0.515,3,5,0.6,7,16,23,11,10,0,6,22,38
Bryant Dunston,Olympiacos,29,563,75,138,0.543,0,1,0,75,137,0.547,0.543,55,89,0.618,50,78,128,17,24,32,25,87,205
Bryce Taylor,FC Bayern Munich,2,39,2,7,0.286,2,4,0.5,0,3,0,0.429,5,6,0.833,2,4,6,3,2,1,0,4,11
Caleb Green,Unicaja Malaga,24,426,64,137,0.467,21,60,0.35,43,77,0.558,0.544,32,53,0.604,30,55,85,17,13,4,27,40,181
Can Altintig,Fenerbahçe,3,26,1,4,0.25,0,0,,1,4,0.25,0.25,0,0,,1,1,2,0,0,0,4,5,2
Carlos Arroyo,Galatasaray,15,443,66,172,0.384,28,81,0.346,38,91,0.418,0.465,28,34,0.824,1,25,26,64,8,0,34,35,188
Carlos Martinez,Laboral Kutxa,1,1,0,0,,0,0,,0,0,,,0,0,,0,0,0,0,0,0,0,0,0
Carlos Suarez,Unicaja Malaga,18,360,35,98,0.357,12,47,0.255,23,51,0.451,0.418,17,21,0.81,36,39,75,25,9,3,11,27,99
Cedi Osman,Anadolu Efes,27,521,60,151,0.397,20,66,0.303,40,85,0.471,0.464,40,60,0.667,22,77,99,29,19,8,23,63,180
Charles Jenkins,Crvena zvezda / Red Star,24,459,58,163,0.356,18,58,0.31,40,105,0.381,0.411,24,30,0.8,7,25,32,32,22,5,18,63,158
Cheikh Mbodj,Banco di Sardegna Sassari,1,20,3,5,0.6,0,0,,3,5,0.6,0.6,2,4,0.5,2,2,4,0,0,3,0,2,8
Chris Wright,PGE Turow Zgorzelec,8,168,30,50,0.6,2,7,0.286,28,43,0.651,0.62,9,12,0.75,13,22,35,2,4,8,9,20,71
Cliff Hammonds,Alba Berlin,20,515,63,138,0.457,24,68,0.353,39,70,0.557,0.543,12,16,0.75,3,39,42,58,12,7,29,60,162
Colton Iverson,Laboral Kutxa,24,500,66,107,0.617,0,1,0,66,106,0.623,0.617,37,68,0.544,66,79,145,12,12,16,16,74,169
Kostas Vasileiadis,Unicaja Malaga,17,254,36,107,0.336,22,74,0.297,14,33,0.424,0.439,17,18,0.944,4,16,20,12,8,1,20,34,111
Curtis Jerrells,UNICS,10,250,41,93,0.441,16,47,0.34,25,46,0.543,0.527,8,11,0.727,3,23,26,29,5,2,20,20,106
Damian Kulig,PGE Turow Zgorzelec,10,253,58,103,0.563,17,36,0.472,41,67,0.612,0.646,19,30,0.633,12,43,55,15,6,11,20,38,152
Daniel Hackett,EA7-Emporio Armani Milano,24,689,90,231,0.39,21,84,0.25,69,147,0.469,0.435,50,76,0.658,6,83,89,110,20,1,37,71,251
Dario Saric,Anadolu Efes,27,658,91,210,0.433,19,62,0.306,72,148,0.486,0.479,65,92,0.707,44,128,172,62,20,12,51,54,266
Darius Adams,Laboral Kutxa,14,323,61,137,0.445,30,72,0.417,31,65,0.477,0.555,19,22,0.864,7,26,33,39,15,1,42,27,171
Darius Songaila,BC Zalgiris,24,348,62,126,0.492,0,0,,62,126,0.492,0.492,14,18,0.778,14,47,61,22,14,2,34,55,138
David Guardia,Valencia Basket,1,3,1,1,1,0,0,,1,1,1,1,0,0,,0,0,0,0,0,0,0,0,2
David Logan,Banco di Sardegna Sassari,10,291,43,123,0.35,24,72,0.333,19,51,0.373,0.447,9,13,0.692,2,19,21,28,23,0,14,17,119
David Moss,EA7-Emporio Armani Milano,23,484,39,98,0.398,21,63,0.333,18,35,0.514,0.505,17,22,0.773,26,45,71,27,17,3,17,63,116
Davis Bertans,Laboral Kutxa,22,482,82,215,0.381,50,141,0.355,32,74,0.432,0.498,29,34,0.853,11,52,63,20,4,11,24,63,243
Deividas Gailius,Neptunas Klaipeda,10,269,54,115,0.47,24,59,0.407,30,56,0.536,0.574,15,25,0.6,9,39,48,25,13,0,21,25,147
DeMarcus Nelson,Panathinaikos,18,321,43,107,0.402,3,23,0.13,40,84,0.476,0.416,15,24,0.625,9,35,44,40,10,3,25,27,104
Demetris Nichols,CSKA Moscow,27,331,45,81,0.556,23,40,0.575,22,41,0.537,0.698,10,12,0.833,14,41,55,9,15,10,19,45,123
Deniz Kilicli,Anadolu Efes,5,37,7,14,0.5,0,0,,7,14,0.5,0.5,0,0,,2,3,5,0,0,0,3,2,14
Deshaun Thomas,FC Barcelona,28,543,81,154,0.526,15,38,0.395,66,116,0.569,0.575,23,36,0.639,34,35,69,13,10,7,12,28,200
Devin Smith,Maccabi Tel Aviv,25,796,130,284,0.458,56,149,0.376,74,135,0.548,0.556,60,72,0.833,25,128,153,62,25,16,45,77,376
Dimitri Sokolov,UNICS,7,62,5,9,0.556,0,0,,5,9,0.556,0.556,5,10,0.5,3,10,13,1,2,2,5,10,15
Dimitrios Katsivelis,Olympiacos,12,75,5,11,0.455,2,6,0.333,3,5,0.6,0.545,0,3,0,1,8,9,4,2,1,3,11,12
Dimitrios Agravanis,Olympiacos,20,249,34,80,0.425,8,34,0.235,26,46,0.565,0.475,5,12,0.417,18,36,54,7,5,7,5,55,81
Dimitris Diamantidis,Panathinaikos,27,738,64,156,0.41,39,103,0.379,25,53,0.472,0.535,48,59,0.814,8,53,61,158,25,7,52,61,215
Dimitriy Khvostov,Nizhny Novgorod,24,547,33,103,0.32,17,52,0.327,16,51,0.314,0.403,17,22,0.773,5,28,33,78,4,0,32,70,100
D.J. White,Laboral Kutxa,2,16,1,5,0.2,0,0,,1,5,0.2,0.2,0,2,0,1,3,4,0,1,0,2,0,2
Dmitry Golovin,Nizhny Novgorod,16,111,2,7,0.286,2,4,0.5,0,3,0,0.429,1,4,0.25,3,5,8,15,2,1,5,13,7
Dogus Balbay,Anadolu Efes,24,205,14,38,0.368,0,9,0,14,29,0.483,0.368,3,3,1,6,15,21,18,4,2,10,35,31
Donatas Tarolis,BC Zalgiris,1,10,1,1,1,0,0,,1,1,1,1,0,0,,0,2,2,1,0,0,1,2,2
Donatas Zavackas,Neptunas Klaipeda,10,259,41,69,0.594,20,35,0.571,21,34,0.618,0.739,18,24,0.75,18,34,52,18,7,0,20,27,120
Donnie McGrath,Anadolu Efes,5,74,8,18,0.444,2,8,0.25,6,10,0.6,0.5,2,2,1,1,6,7,5,2,0,7,9,20
Dontaye Draper,Anadolu Efes,28,670,68,159,0.428,31,86,0.36,37,73,0.507,0.525,30,36,0.833,15,54,69,85,28,7,36,78,197
D'or Fischer,UNICS,10,258,54,72,0.75,0,0,,54,72,0.75,0.75,23,29,0.793,11,46,57,12,9,18,16,25,131
Doron Perkins,Laboral Kutxa,9,97,8,23,0.348,5,14,0.357,3,9,0.333,0.457,5,8,0.625,3,18,21,9,6,0,2,14,26
Dusko Savanovic,FC Bayern Munich,10,252,46,102,0.451,18,39,0.462,28,63,0.444,0.539,21,28,0.75,13,31,44,12,7,2,13,16,131
Dwight Buycks,Valencia Basket,3,61,13,31,0.419,2,7,0.286,11,24,0.458,0.452,8,8,1,2,4,6,6,1,0,6,4,36
Edgar Sosa,Banco di Sardegna Sassari,10,229,35,97,0.361,11,39,0.282,24,58,0.414,0.418,23,32,0.719,2,12,14,42,3,0,28,21,104
Edgaras Ulanovas,BC Zalgiris,24,460,46,99,0.465,10,31,0.323,36,68,0.529,0.515,28,37,0.757,25,36,61,29,14,1,33,51,130
Edwin Jackson,FC Barcelona,11,141,10,33,0.303,3,15,0.2,7,18,0.389,0.348,10,12,0.833,2,13,15,14,4,0,8,16,33
Ege Arar,Galatasaray,8,80,7,22,0.318,2,10,0.2,5,12,0.417,0.364,3,5,0.6,2,9,11,1,1,2,2,10,19
Egidijus Dimsa,Neptunas Klaipeda,10,136,18,39,0.462,2,11,0.182,16,28,0.571,0.487,6,16,0.375,7,16,23,3,2,1,5,26,44
Eleftherios Bochoridis,Panathinaikos,15,150,12,30,0.4,5,11,0.455,7,19,0.368,0.483,1,3,0.333,3,12,15,19,3,0,12,32,30
Emir Preldzic,Fenerbahçe,29,637,63,141,0.447,19,55,0.345,44,86,0.512,0.514,23,31,0.742,17,62,79,91,27,3,35,50,168
Emir Sulejmanovic,FC Barcelona,2,1,0,0,,0,0,,0,0,,,0,0,,0,2,2,0,0,0,0,0,0
Emircan Kosut,Anadolu Efes,4,19,2,6,0.333,1,3,0.333,1,3,0.333,0.417,4,6,0.667,2,4,6,0,0,0,1,4,9
Ender Arslan,Galatasaray,19,341,53,120,0.442,33,73,0.452,20,47,0.426,0.579,25,34,0.735,1,14,15,39,4,0,19,31,164
Esteban Batista,Panathinaikos,26,570,112,192,0.583,0,0,,112,192,0.583,0.583,42,55,0.764,41,101,142,26,25,9,65,63,266
Evgeny Baburin,Nizhny Novgorod,23,426,38,101,0.376,25,66,0.379,13,35,0.371,0.5,12,13,0.923,10,37,47,20,26,0,22,53,113
Fabien Causeur,Laboral Kutxa,23,550,79,156,0.506,20,58,0.345,59,98,0.602,0.571,35,50,0.7,14,48,62,52,29,6,26,49,213
Facu Campazzo,Real Madrid,11,95,10,21,0.476,4,11,0.364,6,10,0.6,0.571,7,10,0.7,0,6,6,22,6,1,8,19,31
Felipe Reyes,Real Madrid,30,573,112,223,0.502,5,17,0.294,107,206,0.519,0.513,92,113,0.814,75,79,154,29,15,10,27,74,321
Fernando San Emeterio,Laboral Kutxa,24,557,85,202,0.421,29,91,0.319,56,111,0.505,0.493,47,59,0.797,10,62,72,43,11,0,20,25,246
Filip Dylewicz,PGE Turow Zgorzelec,9,169,12,41,0.293,6,26,0.231,6,15,0.4,0.366,2,6,0.333,5,23,28,15,7,5,10,15,32
Fran Pilepic,Cedevita Zagreb,10,234,41,78,0.526,25,47,0.532,16,31,0.516,0.686,10,10,1,3,11,14,15,6,0,13,26,117
Fran Vazquez,Unicaja Malaga,24,483,63,117,0.538,0,0,,63,117,0.538,0.538,46,61,0.754,43,74,117,25,19,18,21,64,172
Frank Elegar,EA7-Emporio Armani Milano,6,58,6,11,0.545,0,0,,6,11,0.545,0.545,1,7,0.143,8,13,21,2,0,2,2,5,13
Frejus Zerbo,Limoges CSP,10,114,13,27,0.481,0,0,,13,27,0.481,0.481,2,5,0.4,10,10,20,2,4,0,9,20,28
Furkan Aldemir,Galatasaray,6,124,18,24,0.75,0,0,,18,24,0.75,0.75,11,15,0.733,14,23,37,2,4,8,6,17,47
Furkan Korkmaz,Anadolu Efes,19,204,20,49,0.408,12,29,0.414,8,20,0.4,0.531,15,19,0.789,4,23,27,16,11,0,7,25,67
Gal Mekel,Nizhny Novgorod,6,125,27,56,0.482,2,7,0.286,25,49,0.51,0.5,14,17,0.824,1,13,14,28,4,0,11,16,70
Gani Lawal,Panathinaikos,6,25,6,12,0.5,0,0,,6,12,0.5,0.5,0,2,0,4,6,10,0,0,0,3,7,12
Georgios Diamantakos,Panathinaikos,2,6,0,0,,0,0,,0,0,,,0,0,,1,3,4,0,0,0,3,4,0
German Gabriel,Unicaja Malaga,7,63,7,16,0.438,3,8,0.375,4,8,0.5,0.531,5,7,0.714,5,9,14,4,1,1,3,12,22
Giacomo Devecchi,Banco di Sardegna Sassari,7,113,9,22,0.409,3,8,0.375,6,14,0.429,0.477,1,2,0.5,3,7,10,5,6,0,3,13,22
Giorgos Printezis,Olympiacos,20,506,89,183,0.486,18,60,0.3,71,123,0.577,0.536,48,69,0.696,22,75,97,19,4,2,21,31,244
Gokturk Ural,Galatasaray,8,56,6,11,0.545,2,3,0.667,4,8,0.5,0.636,2,2,1,2,4,6,5,1,0,4,4,16
Guillem Vives,Valencia Basket,10,149,11,31,0.355,4,15,0.267,7,16,0.438,0.419,9,9,1,4,8,12,28,10,0,8,26,35
Gustavo Ayon,Real Madrid,29,543,104,167,0.623,0,0,,104,167,0.623,0.623,27,34,0.794,48,83,131,54,31,17,35,67,235
Guy Pnini,Maccabi Tel Aviv,4,83,13,23,0.565,7,15,0.467,6,8,0.75,0.717,5,8,0.625,1,7,8,6,3,0,7,7,38
Heiko Schaffartzik,FC Bayern Munich,10,218,28,55,0.509,18,39,0.462,10,16,0.625,0.673,14,17,0.824,12,11,23,28,5,0,12,26,88
Ian Vouyoukas,Galatasaray,9,85,8,23,0.348,0,0,,8,23,0.348,0.348,6,9,0.667,5,12,17,9,1,2,4,10,22
Ilimane Diop,Laboral Kutxa,7,31,3,8,0.375,0,0,,3,8,0.375,0.375,6,8,0.75,5,11,16,1,1,4,1,2,12
Ilya Popov,Nizhny Novgorod,2,23,3,6,0.5,0,0,,3,6,0.5,0.5,0,0,,2,6,8,1,2,0,0,2,6
Ioannis Papapetrou,Olympiacos,11,114,16,33,0.485,6,15,0.4,10,18,0.556,0.576,2,4,0.5,2,12,14,4,4,0,5,20,40
Ismet Akpinar,Alba Berlin,5,28,3,7,0.429,2,4,0.5,1,3,0.333,0.571,0,0,,0,2,2,3,2,0,4,5,8
Ivan Ramljak,Cedevita Zagreb,9,170,16,35,0.457,4,12,0.333,12,23,0.522,0.514,1,3,0.333,6,20,26,13,7,2,5,27,37
Ivan Savelyev,Nizhny Novgorod,15,94,5,15,0.333,0,4,0,5,11,0.455,0.333,5,7,0.714,2,8,10,11,4,0,7,28,15
Ivan Strebkov,CSKA Moscow,8,40,5,14,0.357,4,12,0.333,1,2,0.5,0.5,2,2,1,1,0,1,2,1,0,3,11,16
Ivan Viktorov,Nizhny Novgorod,4,22,2,6,0.333,0,0,,2,6,0.333,0.333,1,2,0.5,0,2,2,1,0,0,1,5,5
Ivan Zigeranovic,PGE Turow Zgorzelec,10,108,18,32,0.563,1,1,1,17,31,0.548,0.578,3,9,0.333,6,16,22,1,4,3,12,21,40
Izzet Turkyilmaz,Fenerbahçe,1,0,0,0,,0,0,,0,0,,,0,0,,0,0,0,0,0,0,0,0,0
Jaka Blazic,Crvena zvezda / Red Star,24,512,78,185,0.422,21,68,0.309,57,117,0.487,0.478,42,56,0.75,23,44,67,23,11,2,49,54,219
Jake Cohen,Maccabi Tel Aviv,15,86,8,17,0.471,2,7,0.286,6,10,0.6,0.529,4,5,0.8,6,11,17,4,3,2,8,13,22
Jakub Karolak,PGE Turow Zgorzelec,4,21,2,5,0.4,1,3,0.333,1,2,0.5,0.5,0,0,,0,3,3,0,1,0,0,4,5
Jamar Smith,Limoges CSP,10,261,52,101,0.515,27,59,0.458,25,42,0.595,0.649,9,11,0.818,4,22,26,31,12,1,17,10,140
Jamel McLean,Alba Berlin,21,534,90,161,0.559,0,3,0,90,158,0.57,0.559,94,122,0.77,44,73,117,33,21,5,42,62,274
James Anderson,BC Zalgiris,24,682,126,318,0.396,46,140,0.329,80,178,0.449,0.469,51,65,0.785,18,105,123,60,21,13,50,58,349
James Gist,Panathinaikos,28,644,93,204,0.456,23,72,0.319,70,132,0.53,0.512,57,78,0.731,34,85,119,43,28,16,46,70,266
James Southerland,Limoges CSP,9,91,5,20,0.25,3,13,0.231,2,7,0.286,0.325,3,4,0.75,0,8,8,1,5,7,4,12,16
James White,UNICS,10,278,35,75,0.467,8,25,0.32,27,50,0.54,0.52,22,26,0.846,3,46,49,7,7,3,9,28,100
Jan Jagla,FC Bayern Munich,8,87,7,18,0.389,3,11,0.273,4,7,0.571,0.472,7,9,0.778,5,14,19,1,3,3,5,18,24
Jan Vesely,Fenerbahçe,29,634,136,215,0.633,0,1,0,136,214,0.636,0.633,53,108,0.491,67,89,156,23,23,28,29,94,325
Janis Blums,Panathinaikos,27,322,32,78,0.41,28,66,0.424,4,12,0.333,0.59,10,14,0.714,1,18,19,13,6,0,10,52,102
Jannik Freese,Alba Berlin,3,22,1,7,0.143,0,0,,1,7,0.143,0.143,1,4,0.25,1,1,2,0,0,0,0,4,3
Jaycee Carroll,Real Madrid,30,531,103,197,0.523,50,104,0.481,53,93,0.57,0.65,31,35,0.886,14,47,61,22,16,0,18,38,287
Jayson Granger,Unicaja Malaga,23,589,80,198,0.404,18,57,0.316,62,141,0.44,0.449,57,75,0.76,5,58,63,96,20,6,48,39,235
Jeff Brooks,Banco di Sardegna Sassari,8,233,28,53,0.528,8,17,0.471,20,36,0.556,0.604,10,13,0.769,14,26,40,10,16,5,5,17,74
Jeremy Pargo,Maccabi Tel Aviv,27,864,134,333,0.402,35,124,0.282,99,209,0.474,0.455,66,87,0.759,9,77,86,146,6,2,79,59,369
Jerome Dyson,Banco di Sardegna Sassari,10,239,36,102,0.353,13,45,0.289,23,57,0.404,0.417,17,32,0.531,9,16,25,30,17,1,34,29,102
Joe Alexander,Maccabi Tel Aviv,15,178,25,53,0.472,7,17,0.412,18,36,0.5,0.538,11,12,0.917,9,24,33,8,1,7,8,33,68
Joe Ragland,EA7-Emporio Armani Milano,24,446,61,158,0.386,27,78,0.346,34,80,0.425,0.472,24,29,0.828,11,27,38,70,15,1,21,52,173
John Bryant,FC Bayern Munich,10,222,41,90,0.456,3,11,0.273,38,79,0.481,0.472,23,30,0.767,18,59,77,15,4,6,19,32,108
Jon Stefansson,Unicaja Malaga,20,262,38,96,0.396,14,49,0.286,24,47,0.511,0.469,12,20,0.6,2,9,11,24,3,0,20,41,102
Jonas Maciulis,Real Madrid,27,378,34,92,0.37,15,45,0.333,19,47,0.404,0.451,21,29,0.724,22,44,66,26,17,3,19,41,104
Jonas Wohlfarth,Alba Berlin,15,133,20,41,0.488,0,0,,20,41,0.488,0.488,6,23,0.261,16,13,29,2,5,5,9,24,46
Jonathan Tabu,Alba Berlin,8,127,11,36,0.306,8,23,0.348,3,13,0.231,0.417,3,7,0.429,0,14,14,15,6,0,10,16,33
Joseph Forte,Maccabi Tel Aviv,2,2,0,1,0,0,1,0,0,0,,0,0,0,,0,1,1,0,0,0,1,0,0
JP Batista,Limoges CSP,10,171,30,66,0.455,0,0,,30,66,0.455,0.455,18,22,0.818,9,12,21,10,2,2,10,22,78
Juan Carlos Navarro,FC Barcelona,17,375,51,138,0.37,31,87,0.356,20,51,0.392,0.482,45,52,0.865,4,24,28,52,4,0,22,18,178
Julian Wright,Panathinaikos,9,89,13,25,0.52,0,1,0,13,24,0.542,0.52,8,16,0.5,8,10,18,2,3,8,5,5,34
Justas Sinica,Neptunas Klaipeda,10,116,10,45,0.222,9,35,0.257,1,10,0.1,0.322,0,0,,4,11,15,7,4,1,6,15,29
Justin Carter,Galatasaray,14,359,41,94,0.436,9,31,0.29,32,63,0.508,0.484,25,36,0.694,17,43,60,37,10,7,19,19,116
Justin Doellman,FC Barcelona,26,629,89,208,0.428,22,62,0.355,67,146,0.459,0.481,56,63,0.889,26,85,111,31,21,6,35,48,256
Karlo Zganec,Cedevita Zagreb,9,76,4,13,0.308,0,0,,4,13,0.308,0.308,11,22,0.5,11,13,24,6,5,0,4,11,19
K.C. Rivers,Real Madrid,30,509,60,139,0.432,30,73,0.411,30,66,0.455,0.54,10,10,1,12,56,68,34,18,0,11,48,160
Keith Benson,Neptunas Klaipeda,7,69,12,21,0.571,0,0,,12,21,0.571,0.571,5,6,0.833,12,12,24,0,3,4,5,8,29
Keith Langford,UNICS,10,292,62,126,0.492,12,38,0.316,50,88,0.568,0.54,31,42,0.738,8,27,35,23,11,2,22,19,167
Kenan Karahodzic,Unicaja Malaga,6,34,4,8,0.5,2,5,0.4,2,3,0.667,0.625,2,2,1,3,4,7,1,2,0,2,4,12
Kenan Sipahi,Fenerbahçe,22,215,14,44,0.318,5,26,0.192,9,18,0.5,0.375,3,4,0.75,5,12,17,15,8,0,10,39,36
Kerem Gonlum,Galatasaray,23,401,66,97,0.68,0,1,0,66,96,0.688,0.68,44,59,0.746,36,69,105,14,8,2,24,36,176
Kim Tillie,Laboral Kutxa,24,435,52,115,0.452,10,26,0.385,42,89,0.472,0.496,17,22,0.773,47,64,111,23,18,3,10,57,131
Kostas Kaimakoglou,UNICS,10,309,30,73,0.411,11,32,0.344,19,41,0.463,0.486,8,12,0.667,9,42,51,36,15,3,17,20,79
Kostas Sloukas,Olympiacos,29,522,55,152,0.362,18,52,0.346,37,100,0.37,0.421,66,76,0.868,8,48,56,89,18,4,37,47,194
Kresimir Loncar,Valencia Basket,10,131,24,54,0.444,1,4,0.25,23,50,0.46,0.454,9,14,0.643,11,15,26,10,8,2,11,24,58
Kristijan Nikolov,Galatasaray,8,95,6,20,0.3,5,13,0.385,1,7,0.143,0.425,4,4,1,0,7,7,7,1,0,10,15,21
Kyle Hines,CSKA Moscow,30,526,79,129,0.612,0,2,0,79,127,0.622,0.612,45,66,0.682,57,72,129,16,17,23,21,65,203
Lamine Kante,Limoges CSP,2,7,0,3,0,0,1,0,0,2,0,0,0,0,,0,0,0,0,0,0,1,0,0
Lamont Hamilton,Laboral Kutxa,4,62,7,22,0.318,1,8,0.125,6,14,0.429,0.341,1,2,0.5,3,4,7,4,0,4,4,4,16
Leo Westermann,Limoges CSP,10,234,27,73,0.37,14,38,0.368,13,35,0.371,0.466,9,10,0.9,7,16,23,43,17,1,19,32,77
Leon Radosevic,Alba Berlin,22,459,80,164,0.488,0,1,0,80,163,0.491,0.488,38,53,0.717,23,56,79,18,13,8,43,61,198
Levan Patsatsia,Nizhny Novgorod,11,126,5,29,0.172,1,14,0.071,4,15,0.267,0.19,1,3,0.333,8,17,25,4,3,0,1,15,12
Linas Kleiza,EA7-Emporio Armani Milano,24,469,59,139,0.424,32,91,0.352,27,48,0.563,0.54,26,33,0.788,18,56,74,7,4,3,14,63,176
Loukas Mavrokefalidis,Panathinaikos,22,296,60,128,0.469,5,15,0.333,55,113,0.487,0.488,29,35,0.829,19,54,73,13,5,6,17,48,154
Lovro Mazalin,Cedevita Zagreb,7,47,3,9,0.333,0,1,0,3,8,0.375,0.333,6,9,0.667,0,5,5,3,1,0,3,6,12
Lucca Staiger,FC Bayern Munich,7,88,7,27,0.259,6,21,0.286,1,6,0.167,0.37,1,2,0.5,0,11,11,3,1,0,1,9,21
Ludde Hakanson,FC Barcelona,6,19,1,5,0.2,1,5,0.2,0,0,,0.3,1,2,0.5,0,0,0,2,0,0,1,0,4
Luka Babic,Cedevita Zagreb,8,175,22,63,0.349,11,40,0.275,11,23,0.478,0.437,2,3,0.667,5,24,29,20,8,2,13,14,57
Luka Mitrovic,Crvena zvezda / Red Star,24,593,82,191,0.429,11,63,0.175,71,128,0.555,0.458,32,41,0.78,40,85,125,56,25,5,39,58,207
Luka Zoric,Fenerbahçe,23,299,52,96,0.542,0,0,,52,96,0.542,0.542,30,44,0.682,27,40,67,9,2,11,20,44,134
Lukas Lekavicius,BC Zalgiris,24,455,48,115,0.417,14,42,0.333,34,73,0.466,0.478,21,27,0.778,16,28,44,64,10,1,42,52,131
Lukasz Wisniewski,PGE Turow Zgorzelec,3,47,5,7,0.714,0,1,0,5,6,0.833,0.714,0,0,,1,2,3,5,1,1,3,5,10
Luke Harangody,Valencia Basket,10,231,38,71,0.535,17,35,0.486,21,36,0.583,0.655,12,12,1,14,34,48,9,8,6,8,17,105
Maciej Lampe,FC Barcelona,24,318,54,127,0.425,5,21,0.238,49,106,0.462,0.445,35,43,0.814,34,57,91,15,6,9,14,29,148
Maik Zirbes,Crvena zvezda / Red Star,24,311,51,82,0.622,0,1,0,51,81,0.63,0.622,22,32,0.688,31,47,78,7,13,10,22,38,124
Maksim Krivosheev,Nizhny Novgorod,19,97,12,22,0.545,0,0,,12,22,0.545,0.545,8,14,0.571,6,9,15,1,1,1,8,24,32
Manuchar Markoishvili,CSKA Moscow,18,193,21,46,0.457,9,25,0.36,12,21,0.571,0.554,13,15,0.867,7,15,22,15,7,2,6,38,64
Manuel Vanuzzo,Banco di Sardegna Sassari,5,23,0,2,0,0,2,0,0,0,,0,0,0,,2,1,3,0,1,0,2,4,0
Maodo Nguirane,Unicaja Malaga,5,7,0,1,0,0,0,,0,1,0,0,2,2,1,0,0,0,0,0,0,1,1,2
Marcelo Huertas,FC Barcelona,28,618,81,201,0.403,27,74,0.365,54,127,0.425,0.47,25,30,0.833,6,58,64,122,15,1,56,50,214
Marco Cusin,Banco di Sardegna Sassari,2,31,5,5,1,0,0,,5,5,1,1,0,0,,1,4,5,1,0,2,1,5,10
Marcus Slaughter,Real Madrid,27,329,32,50,0.64,0,0,,32,50,0.64,0.64,16,33,0.485,15,42,57,16,26,6,9,63,80
Marcus Williams,Crvena zvezda / Red Star,24,618,77,243,0.317,38,130,0.292,39,113,0.345,0.395,40,53,0.755,16,61,77,146,19,1,69,30,232
Mardy Collins,PGE Turow Zgorzelec,8,241,41,98,0.418,6,26,0.231,35,72,0.486,0.449,11,21,0.524,9,26,35,31,15,2,20,20,99
Mario Delas,Cedevita Zagreb,10,194,26,55,0.473,1,11,0.091,25,44,0.568,0.482,5,6,0.833,15,16,31,7,4,2,10,32,58
Mario Hezonja,FC Barcelona,22,364,61,132,0.462,29,76,0.382,32,56,0.571,0.572,18,24,0.75,11,33,44,22,13,4,21,40,169
Marko Arapovic,Cedevita Zagreb,10,103,12,27,0.444,1,7,0.143,11,20,0.55,0.463,4,6,0.667,6,11,17,4,1,0,6,21,29
Marko Banic,Alba Berlin,23,448,83,130,0.638,0,0,,83,130,0.638,0.638,36,41,0.878,29,38,67,20,9,6,34,47,202
Marko Tejic,Crvena zvezda / Red Star,17,152,10,28,0.357,4,12,0.333,6,16,0.375,0.429,3,8,0.375,8,15,23,12,1,2,7,38,27
Marko Tomas,Cedevita Zagreb,1,25,2,9,0.222,1,5,0.2,1,4,0.25,0.278,0,0,,2,2,4,0,1,0,0,3,5
MarQuez Haynes,Maccabi Tel Aviv,25,438,40,120,0.333,22,73,0.301,18,47,0.383,0.425,12,21,0.571,6,31,37,31,9,3,22,33,114
MarShon Brooks,EA7-Emporio Armani Milano,24,526,115,257,0.447,33,94,0.351,82,163,0.503,0.512,45,53,0.849,17,49,66,33,16,6,35,45,308
Martin Seiferth,Alba Berlin,2,7,2,2,1,0,0,,2,2,1,1,0,2,0,0,1,1,0,0,0,0,2,4
Martynas Mazeika,Neptunas Klaipeda,9,208,15,58,0.259,5,24,0.208,10,34,0.294,0.302,20,28,0.714,2,14,16,17,6,1,9,18,55
Martynas Pocius,Galatasaray,19,392,38,101,0.376,19,60,0.317,19,41,0.463,0.47,23,30,0.767,10,23,33,27,6,2,33,33,118
Massimo Chessa,Banco di Sardegna Sassari,4,40,6,12,0.5,4,7,0.571,2,5,0.4,0.667,6,8,0.75,0,0,0,3,4,1,0,5,22
Matt Janning,Anadolu Efes,27,584,68,177,0.384,37,110,0.336,31,67,0.463,0.489,13,20,0.65,7,45,52,43,20,1,31,59,186
Matt Lojeski,Olympiacos,25,606,92,188,0.489,38,88,0.432,54,100,0.54,0.59,15,24,0.625,13,82,95,41,26,8,24,43,237
Matteo Formenti,Banco di Sardegna Sassari,3,27,4,9,0.444,2,6,0.333,2,3,0.667,0.556,0,0,,0,3,3,1,1,0,0,6,10
Melih Mahmutoglu,Fenerbahçe,16,119,13,37,0.351,11,28,0.393,2,9,0.222,0.5,0,0,,3,8,11,5,0,0,4,10,37
Michael Gospodarek,PGE Turow Zgorzelec,2,11,0,0,,0,0,,0,0,,,0,0,,0,0,0,0,0,0,2,2,0
Michael Lountzis,Panathinaikos,2,15,1,3,0.333,0,1,0,1,2,0.5,0.333,0,0,,0,2,2,4,0,0,2,1,2
Michal Chylinski,PGE Turow Zgorzelec,8,188,22,50,0.44,12,28,0.429,10,22,0.455,0.56,2,2,1,3,9,12,20,2,0,15,19,58
Michalis Tsairelis,Olympiacos,1,3,1,1,1,0,0,,1,1,1,1,0,0,,0,0,0,0,1,0,0,1,2
Mike James,Laboral Kutxa,16,307,63,156,0.404,14,63,0.222,49,93,0.527,0.449,38,45,0.844,11,27,38,31,18,0,29,36,178
Milko Bjelica,Anadolu Efes,28,454,78,169,0.462,22,53,0.415,56,116,0.483,0.527,39,53,0.736,20,49,69,23,5,9,27,54,217
Milos Teodosic,CSKA Moscow,24,676,113,262,0.431,70,173,0.405,43,89,0.483,0.565,58,67,0.866,6,62,68,168,19,0,88,66,354
Mindaugas Girdziunas,Neptunas Klaipeda,10,167,14,45,0.311,2,18,0.111,12,27,0.444,0.333,13,13,1,3,11,14,20,2,0,12,14,43
Mindaugas Kuzminskas,Unicaja Malaga,24,523,85,189,0.45,19,69,0.275,66,120,0.55,0.5,52,64,0.813,48,61,109,34,21,9,30,28,241
Miro Bilan,Cedevita Zagreb,10,254,50,91,0.549,0,1,0,50,90,0.556,0.549,25,35,0.714,26,40,66,12,4,0,16,29,125
Miroslav Todic,Banco di Sardegna Sassari,10,197,26,77,0.338,11,37,0.297,15,40,0.375,0.409,8,16,0.5,19,29,48,7,7,2,6,20,71
Mirza Begic,Laboral Kutxa,18,311,40,72,0.556,0,0,,40,72,0.556,0.556,43,61,0.705,27,51,78,8,7,30,20,36,123
Morayo Soluade,Unicaja Malaga,4,39,6,16,0.375,3,9,0.333,3,7,0.429,0.469,1,2,0.5,2,2,4,3,4,0,1,4,16
Moritz Wagner,Alba Berlin,2,3,0,0,,0,0,,0,0,,,0,0,,0,1,1,0,1,0,1,1,0
Mustafa Shakur,Neptunas Klaipeda,10,248,36,91,0.396,3,21,0.143,33,70,0.471,0.412,21,24,0.875,0,23,23,38,12,0,20,24,96
Nando De Colo,CSKA Moscow,28,684,134,272,0.493,32,68,0.471,102,204,0.5,0.551,103,112,0.92,14,75,89,88,37,1,50,61,403
Nate Linhart,Maccabi Tel Aviv,20,314,44,84,0.524,19,44,0.432,25,40,0.625,0.637,8,15,0.533,12,43,55,22,18,6,9,42,115
Nathan Jawai,Galatasaray,6,42,7,10,0.7,0,0,,7,10,0.7,0.7,7,10,0.7,6,7,13,1,0,1,4,8,21
Nemanja Bjelica,Fenerbahçe,29,805,123,246,0.5,26,74,0.351,97,172,0.564,0.553,78,114,0.684,54,192,246,56,37,20,43,66,350
Nemanja Dangubic,Crvena zvezda / Red Star,23,328,34,89,0.382,13,38,0.342,21,51,0.412,0.455,13,19,0.684,17,29,46,16,10,3,26,55,94
Nemanja Gordic,Cedevita Zagreb,10,273,37,92,0.402,15,39,0.385,22,53,0.415,0.484,7,8,0.875,5,16,21,39,21,0,29,30,96
Nemanja Jaramaz,PGE Turow Zgorzelec,10,244,28,72,0.389,13,34,0.382,15,38,0.395,0.479,26,30,0.867,9,20,29,29,3,1,8,16,95
Nemanja Nedovic,Valencia Basket,5,97,15,37,0.405,6,15,0.4,9,22,0.409,0.486,4,4,1,1,4,5,18,7,1,11,10,40
Nenad Krstic,Anadolu Efes,20,430,85,146,0.582,0,0,,85,146,0.582,0.582,90,110,0.818,38,63,101,26,6,10,24,39,260
Nicolo Melli,EA7-Emporio Armani Milano,24,499,46,115,0.4,20,60,0.333,26,55,0.473,0.487,14,20,0.7,23,60,83,18,25,14,12,60,126
Niels Giffey,Alba Berlin,24,365,47,106,0.443,19,48,0.396,28,58,0.483,0.533,4,10,0.4,15,41,56,5,11,3,23,52,117
Nihad Dedovic,FC Bayern Munich,10,255,43,98,0.439,12,32,0.375,31,66,0.47,0.5,18,22,0.818,5,23,28,24,5,2,11,20,116
Nikola Kalinic,Crvena zvezda / Red Star,24,624,76,177,0.429,22,62,0.355,54,115,0.47,0.492,47,75,0.627,25,69,94,47,20,5,46,64,221
Nikola Rebic,Crvena zvezda / Red Star,4,6,0,1,0,0,1,0,0,0,,0,0,0,,0,0,0,1,0,0,1,0,0
Nikos Pappas,Panathinaikos,22,447,77,158,0.487,24,62,0.387,53,96,0.552,0.563,60,66,0.909,9,42,51,41,18,2,31,36,238
Nikos Zisis,UNICS,10,261,23,56,0.411,8,19,0.421,15,37,0.405,0.482,16,18,0.889,3,25,28,36,3,0,11,27,70
Nikos Zisis,Fenerbahçe,19,446,37,90,0.411,10,30,0.333,27,60,0.45,0.467,18,30,0.6,7,31,38,68,7,1,23,58,102
Nobel Boungou Colo,Limoges CSP,10,279,35,91,0.385,9,38,0.237,26,53,0.491,0.434,23,29,0.793,13,15,28,22,11,2,23,25,102
Nolan Smith,Galatasaray,1,16,2,9,0.222,0,1,0,2,8,0.25,0.222,2,2,1,1,2,3,1,0,0,2,2,6
Oguz Savas,Fenerbahçe,27,295,55,91,0.604,0,0,,55,91,0.604,0.604,24,30,0.8,34,26,60,22,9,13,24,36,134
Okben Ulubay,Anadolu Efes,2,35,5,9,0.556,1,3,0.333,4,6,0.667,0.611,1,2,0.5,4,1,5,2,1,2,1,4,12
Oliver Lafayette,Olympiacos,29,532,66,171,0.386,44,109,0.404,22,62,0.355,0.515,20,33,0.606,6,54,60,74,14,0,24,53,196
Omer Yurtseven,Fenerbahçe,3,5,1,1,1,0,0,,1,1,1,1,0,0,,1,0,1,1,0,0,0,0,2
Orlando Johnson,Laboral Kutxa,2,30,1,9,0.111,1,2,0.5,0,7,0,0.167,2,2,1,1,2,3,1,1,1,1,5,5
Othello Hunter,Olympiacos,29,552,107,174,0.615,0,0,,107,174,0.615,0.615,25,40,0.625,47,93,140,17,13,11,32,76,239
Ousmane Camara,Limoges CSP,10,107,10,27,0.37,0,2,0,10,25,0.4,0.37,7,9,0.778,14,14,28,1,2,2,9,9,27
Pablo Aguilar,Valencia Basket,10,99,15,31,0.484,5,19,0.263,10,12,0.833,0.565,2,4,0.5,8,15,23,4,4,4,3,7,37
Pablo Perez,Valencia Basket,1,3,0,1,0,0,0,,0,1,0,0,0,0,,0,0,0,1,0,0,1,0,0
Pape-Philippe Amagou,Limoges CSP,4,64,7,16,0.438,5,9,0.556,2,7,0.286,0.594,1,2,0.5,1,6,7,6,2,0,2,10,20
Patric Young,Galatasaray,17,416,59,98,0.602,0,1,0,59,97,0.608,0.602,30,50,0.6,42,67,109,11,15,13,26,34,148
Pau Ribas,Valencia Basket,10,241,45,92,0.489,18,41,0.439,27,51,0.529,0.587,10,13,0.769,3,20,23,36,11,0,9,26,118
Paul Zipser,FC Bayern Munich,3,38,4,8,0.5,2,4,0.5,2,4,0.5,0.625,0,0,,2,3,5,1,1,1,4,5,10
Paulius Jankunas,BC Zalgiris,24,581,73,152,0.48,12,40,0.3,61,112,0.545,0.52,60,75,0.8,26,130,156,26,14,11,43,70,218
Pavel Antipov,UNICS,4,21,2,7,0.286,1,3,0.333,1,4,0.25,0.357,2,2,1,1,1,2,1,0,0,1,0,7
Pavel Korobkov,CSKA Moscow,19,171,20,27,0.741,4,4,1,16,23,0.696,0.815,11,14,0.786,9,16,25,6,3,9,11,33,55
Petr Gubanov,UNICS,7,56,5,11,0.455,2,5,0.4,3,6,0.5,0.545,1,3,0.333,1,4,5,5,0,3,1,6,13
Pietro Aradori,Galatasaray,8,169,17,36,0.472,6,15,0.4,11,21,0.524,0.556,16,20,0.8,1,22,23,16,6,0,4,11,56
Rafael Martinez,Valencia Basket,10,133,8,33,0.242,3,22,0.136,5,11,0.455,0.288,5,7,0.714,1,7,8,7,5,0,9,13,24
Raidas Nacius,Neptunas Klaipeda,1,4,0,0,,0,0,,0,0,,,0,0,,0,2,2,2,0,0,1,1,0
Rakim Sanders,Banco di Sardegna Sassari,8,221,39,96,0.406,14,43,0.326,25,53,0.472,0.479,15,24,0.625,5,19,24,4,7,0,11,32,107
Ramel Curry,Limoges CSP,10,215,28,76,0.368,14,43,0.326,14,33,0.424,0.461,9,11,0.818,5,17,22,28,18,0,22,13,79
Reggie Redding,Alba Berlin,22,640,110,241,0.456,23,63,0.365,87,178,0.489,0.504,29,37,0.784,21,83,104,86,16,9,56,45,272
Ricky Hickman,Fenerbahçe,17,376,41,123,0.333,19,58,0.328,22,65,0.338,0.411,52,65,0.8,11,31,42,34,19,2,25,38,153
Rihards Kuksiks,Nizhny Novgorod,7,151,21,45,0.467,12,27,0.444,9,18,0.5,0.6,5,5,1,1,12,13,4,5,1,1,19,59
Robertas Javtokas,BC Zalgiris,23,533,55,122,0.451,0,4,0,55,118,0.466,0.451,22,33,0.667,32,66,98,26,10,19,29,51,132
Robin Benzing,FC Bayern Munich,8,175,22,51,0.431,8,21,0.381,14,30,0.467,0.51,11,14,0.786,7,14,21,7,6,3,4,21,63
Roko Ukic,Cedevita Zagreb,8,179,28,76,0.368,9,32,0.281,19,44,0.432,0.428,16,19,0.842,5,11,16,39,3,0,18,8,81
Romain Sato,Valencia Basket,9,245,21,58,0.362,7,24,0.292,14,34,0.412,0.422,8,10,0.8,12,31,43,10,8,5,13,23,57
Rudy Fernandez,Real Madrid,25,685,101,243,0.416,49,138,0.355,52,105,0.495,0.516,66,74,0.892,21,65,86,82,38,2,32,41,317
Ryan Gomes,Laboral Kutxa,1,16,4,9,0.444,0,4,0,4,5,0.8,0.444,0,0,,0,7,7,1,0,0,2,3,8
Ryan Toolson,Unicaja Malaga,22,507,83,203,0.409,37,100,0.37,46,103,0.447,0.5,37,41,0.902,10,19,29,56,13,0,43,31,240
Salah Mejri,Real Madrid,9,87,15,25,0.6,0,1,0,15,24,0.625,0.6,10,21,0.476,9,12,21,1,4,7,8,13,40
Sam Van Rossom,Valencia Basket,5,150,23,49,0.469,7,21,0.333,16,28,0.571,0.541,4,7,0.571,2,10,12,25,6,0,7,13,57
Samardo Samuels,EA7-Emporio Armani Milano,23,601,109,199,0.548,7,30,0.233,102,169,0.604,0.565,72,104,0.692,54,71,125,17,9,11,39,65,297
Sasha Kaun,CSKA Moscow,30,604,112,162,0.691,0,0,,112,162,0.691,0.691,74,110,0.673,50,84,134,15,13,26,30,57,298
Sasha Vujacic,Laboral Kutxa,8,133,14,46,0.304,7,24,0.292,7,22,0.318,0.38,4,6,0.667,1,14,15,6,2,1,10,18,39
Semen Antonov,Nizhny Novgorod,24,615,62,162,0.383,33,86,0.384,29,76,0.382,0.485,14,20,0.7,23,56,79,40,12,15,34,74,171
Semih Erden,Fenerbahçe,25,255,47,62,0.758,0,0,,47,62,0.758,0.758,21,36,0.583,26,36,62,10,3,6,18,50,115
Sergei Lishouk,Valencia Basket,6,73,6,18,0.333,0,0,,6,18,0.333,0.333,6,9,0.667,4,11,15,1,1,1,7,16,18
Sergey Bykov,UNICS,10,82,6,19,0.316,3,7,0.429,3,12,0.25,0.395,3,4,0.75,2,7,9,5,2,0,12,18,18
Sergio Llull,Real Madrid,30,825,107,245,0.437,53,140,0.379,54,105,0.514,0.545,46,56,0.821,7,44,51,175,25,2,24,55,313
Sergio Rodriguez,Real Madrid,28,604,108,247,0.437,43,113,0.381,65,134,0.485,0.524,51,61,0.836,6,33,39,143,28,1,37,46,310
Serhat Cetin,Fenerbahçe,8,61,5,7,0.714,4,5,0.8,1,2,0.5,1,0,0,,0,7,7,5,0,1,2,8,14
Shane Lawal,Banco di Sardegna Sassari,10,230,37,60,0.617,0,0,,37,60,0.617,0.617,16,34,0.471,43,30,73,14,15,15,17,27,90
Shawn James,EA7-Emporio Armani Milano,18,230,25,47,0.532,0,3,0,25,44,0.568,0.532,11,25,0.44,28,29,57,8,7,17,8,38,61
Siim Sander Vene,BC Zalgiris,14,129,18,40,0.45,7,16,0.438,11,24,0.458,0.538,5,7,0.714,11,6,17,7,7,0,4,19,48
Simas Galdikas,Neptunas Klaipeda,10,193,24,38,0.632,0,0,,24,38,0.632,0.632,12,16,0.75,16,31,47,9,8,3,10,35,60
Sinan Guler,Galatasaray,22,542,71,175,0.406,10,61,0.164,61,114,0.535,0.434,16,20,0.8,10,55,65,51,25,7,45,49,168
Sofoklis Schortsanitis,Maccabi Tel Aviv,26,381,65,123,0.528,0,0,,65,123,0.528,0.528,45,82,0.549,17,44,61,25,8,11,40,84,175
Sonny Weems,CSKA Moscow,26,700,128,301,0.425,46,124,0.371,82,177,0.463,0.502,38,48,0.792,14,89,103,90,26,4,58,64,340
Steed Tchicamboud,Limoges CSP,4,55,3,11,0.273,1,6,0.167,2,5,0.4,0.318,6,6,1,0,5,5,7,0,0,8,7,13
Stefan Jovic,Crvena zvezda / Red Star,19,258,22,61,0.361,6,23,0.261,16,38,0.421,0.41,5,8,0.625,4,36,40,53,19,1,23,32,55
Stefan Markovic,Unicaja Malaga,21,397,28,82,0.341,12,43,0.279,16,39,0.41,0.415,16,24,0.667,12,39,51,72,14,0,33,46,84
Stephane Lasme,Anadolu Efes,28,543,83,160,0.519,0,2,0,83,158,0.525,0.519,24,41,0.585,32,74,106,27,18,23,34,75,190
Stratos Perperoglou,Anadolu Efes,27,644,86,222,0.387,33,96,0.344,53,126,0.421,0.462,59,68,0.868,18,81,99,35,23,5,25,70,264
Suacan Piskin,Galatasaray,2,4,0,1,0,0,0,,0,1,0,0,0,0,,1,0,1,1,0,0,0,0,0
Sylven Landesberg,Maccabi Tel Aviv,19,346,63,138,0.457,17,54,0.315,46,84,0.548,0.518,18,28,0.643,11,37,48,7,5,1,12,30,161
Tarence Kinsey,Nizhny Novgorod,17,525,80,193,0.415,20,54,0.37,60,139,0.432,0.466,55,70,0.786,18,69,87,30,27,3,35,48,235
Taylor Rochestie,Nizhny Novgorod,21,631,135,264,0.511,53,106,0.5,82,158,0.519,0.612,74,80,0.925,10,23,33,120,13,0,47,39,397
Thomas Heurtel,Anadolu Efes,18,432,63,151,0.417,24,61,0.393,39,90,0.433,0.497,19,23,0.826,4,40,44,112,10,1,46,39,169
Thomas Heurtel,Laboral Kutxa,10,283,41,77,0.532,18,32,0.563,23,45,0.511,0.649,22,28,0.786,4,24,28,67,9,0,29,19,122
Tibor Pleiss,FC Barcelona,25,327,52,89,0.584,1,2,0.5,51,87,0.586,0.59,28,33,0.848,29,69,98,6,5,15,20,55,133
Tomas Dimsa,BC Zalgiris,10,67,7,24,0.292,0,3,0,7,21,0.333,0.292,0,2,0,4,5,9,7,2,0,2,13,14
Tomas Satoransky,FC Barcelona,27,519,63,134,0.47,18,46,0.391,45,88,0.511,0.537,51,60,0.85,24,56,80,87,22,5,26,57,195
Tomislav Zubcic,Cedevita Zagreb,10,172,22,57,0.386,14,33,0.424,8,24,0.333,0.509,12,15,0.8,8,22,30,12,6,1,9,12,70
Tony Taylor,PGE Turow Zgorzelec,10,296,31,74,0.419,6,19,0.316,25,55,0.455,0.459,37,44,0.841,1,26,27,38,6,0,16,22,105
Tornike Shengelia,Laboral Kutxa,24,517,73,183,0.399,8,35,0.229,65,148,0.439,0.421,73,89,0.82,41,74,115,20,14,16,32,51,227
Tremmell Darden,Olympiacos,27,424,43,111,0.387,9,34,0.265,34,77,0.442,0.428,18,23,0.783,15,33,48,14,14,11,19,37,113
Trent Meacham,EA7-Emporio Armani Milano,7,45,3,9,0.333,1,7,0.143,2,2,1,0.389,0,0,,0,6,6,1,1,0,2,10,7
Trent Plaisted,Limoges CSP,10,132,12,22,0.545,0,0,,12,22,0.545,0.545,6,18,0.333,10,16,26,2,4,3,5,20,30
Trey Thompkins,Nizhny Novgorod,23,633,129,267,0.483,34,91,0.374,95,176,0.54,0.547,41,49,0.837,35,152,187,37,19,10,38,70,333
Uros Nikolic,PGE Turow Zgorzelec,10,81,13,24,0.542,0,0,,13,24,0.542,0.542,11,17,0.647,9,15,24,3,0,1,9,25,37
Vadim Panin,UNICS,4,22,4,6,0.667,4,6,0.667,0,0,,1,0,0,,0,2,2,0,1,0,0,5,12
Vaidas Kariniauskas,BC Zalgiris,14,227,20,55,0.364,3,16,0.188,17,39,0.436,0.391,7,15,0.467,4,21,25,22,7,5,28,24,50
Valdas Vasylius,Neptunas Klaipeda,10,148,26,56,0.464,6,23,0.261,20,33,0.606,0.518,10,18,0.556,8,18,26,8,2,1,7,15,68
Valeri Likhodei,UNICS,4,5,0,1,0,0,0,,0,1,0,0,0,0,,0,1,1,0,0,1,0,1,0
Vangelis Mantzaris,Olympiacos,29,650,52,120,0.433,31,85,0.365,21,35,0.6,0.563,14,23,0.609,13,52,65,72,18,1,30,78,149
Vasilije Micic,FC Bayern Munich,6,108,18,40,0.45,2,10,0.2,16,30,0.533,0.475,7,8,0.875,2,7,9,19,3,0,14,8,45
Vassilis Charalampopoulos,Panathinaikos,12,106,8,14,0.571,4,7,0.571,4,7,0.571,0.714,6,8,0.75,3,11,14,8,3,2,8,8,26
Vassilis Kavvadas,Olympiacos,11,59,4,14,0.286,0,0,,4,14,0.286,0.286,3,8,0.375,7,8,15,2,1,1,7,17,11
Vassilis Spanoulis,Olympiacos,26,731,110,278,0.396,50,150,0.333,60,128,0.469,0.486,104,137,0.759,5,41,46,142,21,2,80,56,374
Viktor Khryapa,CSKA Moscow,11,88,4,16,0.25,1,7,0.143,3,9,0.333,0.281,5,6,0.833,4,16,20,13,3,6,9,9,14
Viktor Sanikidze,UNICS,10,103,14,20,0.7,1,5,0.2,13,15,0.867,0.725,4,10,0.4,12,15,27,5,1,2,5,20,33
Vitaly Fridzon,CSKA Moscow,23,422,58,139,0.417,30,71,0.423,28,68,0.412,0.525,34,39,0.872,12,41,53,33,17,2,23,59,180
Vlad Moldoveanu,PGE Turow Zgorzelec,10,172,22,52,0.423,13,28,0.464,9,24,0.375,0.548,12,14,0.857,7,16,23,3,5,1,8,34,69
Vladimir Golubovic,Unicaja Malaga,24,388,62,119,0.521,0,0,,62,119,0.521,0.521,35,54,0.648,39,77,116,12,4,4,23,24,159
Vladimir Ivlev,Nizhny Novgorod,17,98,10,22,0.455,0,2,0,10,20,0.5,0.455,1,4,0.25,9,7,16,2,2,0,5,27,21
Vladimir Lucic,Valencia Basket,8,206,20,42,0.476,8,19,0.421,12,23,0.522,0.571,16,21,0.762,7,19,26,7,7,3,4,26,64
Vladimir Micov,Galatasaray,20,566,68,172,0.395,19,61,0.311,49,111,0.441,0.451,43,51,0.843,13,47,60,46,13,2,27,44,198
Vladimir Stimac,FC Bayern Munich,10,153,26,48,0.542,1,3,0.333,25,45,0.556,0.552,16,24,0.667,11,30,41,6,2,2,5,23,69
Vlantimir Giankovits,Panathinaikos,27,710,74,200,0.37,32,96,0.333,42,104,0.404,0.45,43,58,0.741,30,69,99,56,31,5,25,79,223
Vojdan Stojanovski,Alba Berlin,11,144,17,45,0.378,7,19,0.368,10,26,0.385,0.456,6,8,0.75,2,11,13,13,6,0,6,16,47
Vytautas Sarakauskas,Neptunas Klaipeda,1,5,1,3,0.333,0,1,0,1,2,0.5,0.333,0,0,,0,1,1,0,0,0,0,0,2
Vytenis Lipkevicius,BC Zalgiris,14,101,12,20,0.6,3,5,0.6,9,15,0.6,0.675,3,5,0.6,5,12,17,13,5,0,10,13,30
Will Cherry,BC Zalgiris,15,278,38,96,0.396,14,38,0.368,24,58,0.414,0.469,17,24,0.708,4,32,36,25,15,2,24,25,107
Will Daniels,Nizhny Novgorod,2,22,4,12,0.333,0,2,0,4,10,0.4,0.333,3,4,0.75,3,5,8,0,0,1,2,1,11
Will Thomas,Unicaja Malaga,24,494,67,131,0.511,8,28,0.286,59,103,0.573,0.542,24,33,0.727,47,62,109,21,6,3,15,28,166
Yassin Idbihi,FC Bayern Munich,5,45,7,9,0.778,0,0,,7,9,0.778,0.778,0,0,,1,5,6,0,0,1,3,7,14
Ioannis Bourousis,Real Madrid,28,332,53,105,0.505,2,10,0.2,51,95,0.537,0.514,32,44,0.727,27,66,93,25,14,12,25,47,140
Yogev Ohayon,Maccabi Tel Aviv,26,652,52,146,0.356,22,58,0.379,30,88,0.341,0.432,18,32,0.563,17,64,81,100,36,2,47,56,144
Zoran Erceg,Galatasaray,22,675,100,245,0.408,50,129,0.388,50,116,0.431,0.51,80,89,0.899,20,75,95,20,26,3,26,38,330