Player,Team,G,MP,FG,FGA,FG%,3P,3PA,3P%,2P,2PA,2P%,eFG%,FT,FTA,FT%,ORB,DRB,TRB,AST,STL,BLK,TOV,PF,PTS
Aaron Cel,Zielona Góra,8,166,23,48,0.479,6,18,0.333,17,30,0.567,0.542,0,0,,11,24,35,7,4,2,6,17,52
Aaron Jackson,CSKA Moscow,30,519,52,107,0.486,13,43,0.302,39,64,0.609,0.547,28,34,0.824,11,36,47,60,20,1,22,40,145
Acie Law,Olympiacos,9,159,9,27,0.333,1,8,0.125,8,19,0.421,0.352,12,20,0.6,2,8,10,21,8,0,17,13,31
Adam Hanga,Laboral Kutxa,15,257,31,69,0.449,8,28,0.286,23,41,0.561,0.507,14,25,0.56,9,22,31,17,11,7,18,30,84
Adam Hrycaniuk,Zielona Góra,10,132,15,36,0.417,0,0,,15,36,0.417,0.417,4,11,0.364,14,21,35,6,0,1,5,16,34
Alberto Martin,Real Madrid,2,5,0,0,,0,0,,0,0,,,0,0,,0,0,0,1,1,0,0,1,0
Aleks Maric,Lokomotiv Kuban,23,391,50,83,0.602,0,0,,50,83,0.602,0.602,40,68,0.588,27,57,84,24,20,13,38,71,140
Aleksandar Cvetkovic,Crvena zvezda / Red Star,3,12,0,0,,0,0,,0,0,,,4,4,1,0,1,1,2,1,0,2,3,4
Aleksey Zozulin,CSKA Moscow,4,10,1,2,0.5,1,1,1,0,1,0,0.75,0,0,,0,0,0,0,1,0,2,1,3
Alessandro Gentile,EA7-Emporio Armani Milano,21,525,89,201,0.443,21,63,0.333,68,138,0.493,0.495,41,64,0.641,12,39,51,49,17,2,42,51,240
Alex Abrines,FC Barcelona Regal,28,465,68,149,0.456,31,84,0.369,37,65,0.569,0.56,20,26,0.769,13,24,37,19,11,4,23,52,187
Alex Tyus,Maccabi Tel Aviv,27,489,94,131,0.718,0,1,0,94,130,0.723,0.718,20,38,0.526,54,82,136,7,8,29,17,50,208
Alexey Zhukanenko,Lokomotiv Kuban,14,62,5,13,0.385,1,3,0.333,4,10,0.4,0.423,5,10,0.5,4,11,15,2,0,6,7,10,16
Alexis Ajinca,Strasbourg IG,9,228,63,114,0.553,0,1,0,63,113,0.558,0.553,28,37,0.757,15,34,49,17,7,8,20,32,154
Ali Traore,JSF Nanterre,9,132,35,56,0.625,0,0,,35,56,0.625,0.625,8,13,0.615,7,20,27,4,3,3,13,13,78
Andreas Glyniadakis,Lietuvos rytas,9,91,7,17,0.412,0,0,,7,17,0.412,0.412,7,10,0.7,4,11,15,1,2,5,6,25,21
Andres Nocioni,Laboral Kutxa,21,552,98,215,0.456,29,83,0.349,69,132,0.523,0.523,60,76,0.789,18,120,138,35,18,27,45,57,285
Andrey Vorontsevich,CSKA Moscow,25,393,41,80,0.513,14,35,0.4,27,45,0.6,0.6,18,22,0.818,26,52,78,24,11,4,10,36,114
Andrey Zubkov,Lokomotiv Kuban,21,172,24,60,0.4,13,27,0.481,11,33,0.333,0.508,16,25,0.64,7,15,22,10,8,4,8,36,77
Andrija Zizic,Maccabi Tel Aviv,10,49,4,9,0.444,0,0,,4,9,0.444,0.444,0,0,,4,9,13,4,0,0,3,12,8
Andriy Lebedintsev,BC Budivelnyk,6,24,2,4,0.5,1,2,0.5,1,2,0.5,0.625,0,0,,0,1,1,1,1,0,3,0,5
Angelo Gigli,EA7-Emporio Armani Milano,2,25,2,3,0.667,0,0,,2,3,0.667,0.667,1,2,0.5,5,3,8,1,1,0,0,3,5
Ante Tomic,FC Barcelona Regal,29,647,141,225,0.627,0,1,0,141,224,0.629,0.627,58,87,0.667,69,117,186,62,14,17,45,80,340
Antoine Diot,Strasbourg IG,9,248,24,62,0.387,11,36,0.306,13,26,0.5,0.476,16,21,0.762,3,20,23,34,17,3,21,21,75
Anton Gavel,Brose Baskets,10,280,37,83,0.446,17,34,0.5,20,49,0.408,0.548,25,31,0.806,8,17,25,34,7,1,13,20,116
Anton Ponkrashov,Lokomotiv Kuban,7,111,12,34,0.353,2,9,0.222,10,25,0.4,0.382,5,8,0.625,3,8,11,6,2,0,7,7,31
Antonis Fotsis,Panathinaikos,29,679,57,138,0.413,38,106,0.358,19,32,0.594,0.551,23,29,0.793,31,94,125,19,9,7,9,52,175
Arad Harari,Maccabi Tel Aviv,1,2,0,0,,0,0,,0,0,,,0,0,,0,0,0,1,0,0,1,0,0
Arnaud Imhoff,Strasbourg IG,1,1,0,0,,0,0,,0,0,,,0,0,,0,0,0,0,0,0,1,0,0
Artur Drozdov,BC Budivelnyk,4,121,7,20,0.35,3,11,0.273,4,9,0.444,0.425,0,2,0,3,13,16,6,9,2,10,4,17
Arturas Gudaitis,BC Zalgiris,7,72,12,20,0.6,0,4,0,12,16,0.75,0.6,7,11,0.636,4,14,18,4,3,5,2,7,31
Arturas Milaknis,BC Zalgiris,24,439,54,118,0.458,41,95,0.432,13,23,0.565,0.631,4,6,0.667,9,40,49,17,6,1,13,43,153
Axel Toupane,Strasbourg IG,10,150,11,30,0.367,1,8,0.125,10,22,0.455,0.383,2,4,0.5,8,17,25,9,3,1,5,18,25
Ayberk Olmaz,Fenerbahçe,1,2,0,1,0,0,0,,0,1,0,0,0,0,,0,1,1,0,0,0,0,0,0
Baris Ermis,Fenerbahçe,1,7,0,1,0,0,1,0,0,0,,0,0,0,,0,0,0,1,0,0,0,0,0
Ben Altit,Maccabi Tel Aviv,3,5,0,1,0,0,0,,0,1,0,0,0,0,,0,0,0,0,0,1,0,1,0
Benjamin Ortner,Montepaschi Siena,10,157,17,40,0.425,0,1,0,17,39,0.436,0.425,2,4,0.5,10,14,24,5,2,2,8,22,36
Berk Ugurlu,Fenerbahçe,1,30,6,8,0.75,0,1,0,6,7,0.857,0.75,0,0,,1,3,4,7,1,0,2,1,12
Birkan Batuk,Anadolu Efes,19,346,34,86,0.395,14,44,0.318,20,42,0.476,0.477,5,9,0.556,13,26,39,8,12,0,12,53,87
Blagota Sekulic,Fenerbahçe,4,47,3,8,0.375,0,0,,3,8,0.375,0.375,2,2,1,4,6,10,2,1,1,0,10,8
Blake Ahearn,BC Budivelnyk,9,202,27,72,0.375,13,36,0.361,14,36,0.389,0.465,19,21,0.905,2,13,15,14,0,1,15,23,86
Blake Schilb,Crvena zvezda / Red Star,10,286,46,93,0.495,11,29,0.379,35,64,0.547,0.554,17,22,0.773,7,25,32,35,8,2,34,18,120
Bo McCalebb,Fenerbahçe,24,648,106,178,0.596,14,39,0.359,92,139,0.662,0.635,60,81,0.741,22,55,77,61,34,3,35,53,286
Boban Marjanovic,Crvena zvezda / Red Star,10,199,45,72,0.625,0,0,,45,72,0.625,0.625,18,29,0.621,26,51,77,10,8,9,17,18,108
Bogdan Bogdanovic,Partizan,23,722,119,297,0.401,50,135,0.37,69,162,0.426,0.485,52,69,0.754,17,68,85,84,36,5,78,60,340
Bojan Bogdanovic,Fenerbahçe,24,734,130,278,0.468,28,94,0.298,102,184,0.554,0.518,67,82,0.817,11,46,57,45,13,10,45,43,355
Boris Dallo,Partizan,22,198,12,37,0.324,1,5,0.2,11,32,0.344,0.338,0,2,0,8,13,21,17,5,1,7,23,25
Boris Savovic,FC Bayern Munich,21,286,39,99,0.394,8,30,0.267,31,69,0.449,0.434,13,16,0.813,29,39,68,14,3,1,13,29,99
Bostjan Nachbar,FC Barcelona Regal,28,512,80,183,0.437,27,75,0.36,53,108,0.491,0.511,33,45,0.733,15,70,85,28,10,3,24,75,220
Brad Oleson,FC Barcelona Regal,20,420,62,132,0.47,30,66,0.455,32,66,0.485,0.583,24,32,0.75,6,28,34,30,9,8,9,23,178
Branko Lazic,Crvena zvezda / Red Star,10,143,9,19,0.474,3,7,0.429,6,12,0.5,0.553,5,6,0.833,4,9,13,7,1,0,5,26,26
Brent Petway,Olympiacos,25,478,58,112,0.518,28,64,0.438,30,48,0.625,0.643,14,21,0.667,30,58,88,22,10,25,18,80,158
Bruno Cerella,EA7-Emporio Armani Milano,21,204,16,33,0.485,8,16,0.5,8,17,0.471,0.606,3,5,0.6,8,17,25,16,9,1,8,26,43
Bryant Dunston,Olympiacos,29,716,120,179,0.67,0,2,0,120,177,0.678,0.67,60,106,0.566,73,82,155,28,31,38,21,88,300
Bryce Taylor,FC Bayern Munich,22,517,68,147,0.463,25,49,0.51,43,98,0.439,0.548,27,30,0.9,23,53,76,27,25,1,22,65,188
Carlos Arroyo,Galatasaray,25,793,125,299,0.418,45,130,0.346,80,169,0.473,0.493,47,55,0.855,8,42,50,140,11,1,34,54,342
Carlos Martinez,Laboral Kutxa,1,2,0,0,,0,0,,0,0,,,0,0,,0,0,0,0,0,0,0,2,0
Carlos Suarez,Unicaja Malaga,24,588,39,123,0.317,25,83,0.301,14,40,0.35,0.419,30,36,0.833,27,68,95,51,15,5,35,38,133
Casey Jacobsen,Brose Baskets,10,203,23,53,0.434,16,36,0.444,7,17,0.412,0.585,7,8,0.875,6,15,21,13,2,0,12,20,69
Cedi Osman,Anadolu Efes,13,151,17,39,0.436,11,21,0.524,6,18,0.333,0.577,4,10,0.4,5,17,22,12,6,1,4,24,49
Cedric Simmons,Olympiacos,22,242,32,58,0.552,0,1,0,32,57,0.561,0.552,20,37,0.541,27,40,67,3,3,11,18,35,84
Cenk Akyol,Galatasaray,20,292,33,83,0.398,24,53,0.453,9,30,0.3,0.542,10,12,0.833,7,24,31,8,9,1,8,33,100
Charles Jenkins,Crvena zvezda / Red Star,10,227,34,78,0.436,13,23,0.565,21,55,0.382,0.519,13,17,0.765,2,12,14,17,22,2,20,26,94
Chevon Troutman,FC Bayern Munich,20,342,57,102,0.559,4,21,0.19,53,81,0.654,0.578,18,26,0.692,28,49,77,13,12,2,13,38,136
Christian Eyenga,Zielona Góra,10,277,39,85,0.459,1,5,0.2,38,80,0.475,0.465,13,20,0.65,10,37,47,15,5,9,14,23,92
Kostas Vasileiadis,Anadolu Efes,23,626,78,188,0.415,56,139,0.403,22,49,0.449,0.564,37,41,0.902,9,53,62,32,18,3,25,49,249
Craig Brackins,Zielona Góra,10,153,24,47,0.511,7,20,0.35,17,27,0.63,0.585,0,0,,9,10,19,6,2,2,4,16,55
Curtis Jerrells,EA7-Emporio Armani Milano,28,675,113,257,0.44,51,121,0.421,62,136,0.456,0.539,39,58,0.672,7,56,63,69,19,1,47,37,316
Daequan Cook,BC Budivelnyk,4,77,12,30,0.4,7,17,0.412,5,13,0.385,0.517,5,6,0.833,2,5,7,4,3,0,8,8,36
Dainius Salenga,BC Budivelnyk,7,173,23,43,0.535,6,18,0.333,17,25,0.68,0.605,4,5,0.8,3,14,17,17,5,1,6,8,56
DaJuan Summers,BC Budivelnyk,10,278,46,108,0.426,6,27,0.222,40,81,0.494,0.454,25,31,0.806,14,32,46,10,15,6,14,15,123
Damir Markota,Brose Baskets,6,99,11,30,0.367,3,14,0.214,8,16,0.5,0.417,0,0,,7,9,16,6,3,0,4,3,25
Daniel Diez,Real Madrid,24,190,19,40,0.475,4,15,0.267,15,25,0.6,0.525,1,4,0.25,7,12,19,7,8,0,6,15,43
Daniel Hackett,EA7-Emporio Armani Milano,18,484,57,151,0.377,18,56,0.321,39,95,0.411,0.437,42,58,0.724,9,54,63,64,24,1,33,53,174
Daniel Hackett,Montepaschi Siena,9,302,38,89,0.427,9,22,0.409,29,67,0.433,0.478,35,47,0.745,4,34,38,52,9,23,23,22,120
Daniel Schmidt,Brose Baskets,2,10,1,3,0.333,0,1,0,1,2,0.5,0.333,0,0,,0,1,1,4,0,0,0,3,2
Darius Songaila,Lietuvos rytas,10,219,35,74,0.473,0,0,,35,74,0.473,0.473,12,18,0.667,17,31,48,13,7,1,19,25,82
Darjus Lavrinovic,BC Budivelnyk,10,300,54,97,0.557,13,32,0.406,41,65,0.631,0.624,30,34,0.882,11,43,54,18,10,14,21,29,151
David Barlow,Zielona Góra,5,79,8,21,0.381,5,13,0.385,3,8,0.375,0.5,0,0,,3,5,8,5,2,0,1,6,21
David Bluthenthal,Maccabi Tel Aviv,30,744,104,240,0.433,63,155,0.406,41,85,0.482,0.565,31,38,0.816,25,72,97,31,18,0,26,65,302
David Chiotti,EA7-Emporio Armani Milano,7,62,10,12,0.833,0,0,,10,12,0.833,0.833,3,6,0.5,7,11,18,3,2,0,1,6,23
David Cournooh,Montepaschi Siena,8,67,5,16,0.313,2,6,0.333,3,10,0.3,0.375,5,6,0.833,1,5,6,2,2,0,2,8,17
David Jelinek,Laboral Kutxa,23,428,58,112,0.518,25,56,0.446,33,56,0.589,0.629,16,20,0.8,5,26,31,29,13,0,25,54,157
David Lighty,JSF Nanterre,7,213,30,70,0.429,9,26,0.346,21,44,0.477,0.493,10,18,0.556,9,18,27,19,5,4,13,15,79
David Moss,EA7-Emporio Armani Milano,26,647,65,144,0.451,36,99,0.364,29,45,0.644,0.576,24,30,0.8,22,72,94,38,26,3,22,81,190
Davis Bertans,Partizan,4,88,20,46,0.435,10,23,0.435,10,23,0.435,0.543,0,0,,3,12,15,5,3,2,5,15,50
Dejan Musli,Partizan,23,336,51,102,0.5,0,1,0,51,101,0.505,0.5,21,39,0.538,26,47,73,8,7,3,19,32,123
Dejan Todorovic,Unicaja Malaga,5,7,1,3,0.333,0,2,0,1,1,1,0.333,0,0,,0,1,1,1,1,0,0,0,2
DeMarcus Nelson,Crvena zvezda / Red Star,10,267,45,94,0.479,8,28,0.286,37,66,0.561,0.521,14,19,0.737,13,27,40,32,9,2,12,23,112
Deniz Kilicli,Anadolu Efes,9,64,8,16,0.5,0,0,,8,16,0.5,0.5,1,7,0.143,5,10,15,0,1,0,4,20,17
Deon Thompson,FC Bayern Munich,21,397,64,141,0.454,1,5,0.2,63,136,0.463,0.457,25,44,0.568,55,43,98,11,7,8,25,41,154
Derrick Brown,Lokomotiv Kuban,23,662,129,227,0.568,4,11,0.364,125,216,0.579,0.577,55,77,0.714,25,79,104,38,33,10,36,35,317
Deshaun Thomas,JSF Nanterre,10,189,36,84,0.429,14,41,0.341,22,43,0.512,0.512,9,12,0.75,11,17,28,1,4,2,19,13,95
Devin Smith,Maccabi Tel Aviv,28,784,104,209,0.498,39,95,0.411,65,114,0.57,0.591,29,34,0.853,33,124,157,29,16,15,30,83,276
Devon Van Oostrum,Laboral Kutxa,10,72,4,18,0.222,1,11,0.091,3,7,0.429,0.25,3,6,0.5,3,8,11,6,2,0,6,10,12
Dimitrios Katsivelis,Olympiacos,15,69,5,13,0.385,4,7,0.571,1,6,0.167,0.538,1,2,0.5,0,6,6,8,1,2,2,11,15
Dimitrios Agravanis,Olympiacos,8,58,1,13,0.077,0,8,0,1,5,0.2,0.077,2,2,1,2,10,12,2,2,2,2,19,4
Dimitris Diamantidis,Panathinaikos,29,905,70,216,0.324,43,152,0.283,27,64,0.422,0.424,74,97,0.763,6,64,70,180,42,4,88,62,257
Djoko Salic,Partizan,8,16,2,6,0.333,0,1,0,2,5,0.4,0.333,1,4,0.25,2,0,2,2,1,0,1,6,5
Djordje Gagic,Partizan,23,345,26,68,0.382,0,0,,26,68,0.382,0.382,24,38,0.632,36,42,78,22,11,5,30,64,76
Dogukan Sonmez,Galatasaray,3,15,1,3,0.333,0,0,,1,3,0.333,0.333,0,0,,0,3,3,0,0,0,1,2,2
Dogus Balbay,Anadolu Efes,18,257,25,57,0.439,0,8,0,25,49,0.51,0.439,2,6,0.333,17,15,32,14,21,2,12,32,52
Domantas Sabonis,Unicaja Malaga,19,177,22,46,0.478,0,0,,22,46,0.478,0.478,8,12,0.667,12,26,38,5,4,2,12,29,52
Dontaye Draper,Real Madrid,20,228,11,39,0.282,7,21,0.333,4,18,0.222,0.372,5,6,0.833,1,13,14,25,16,0,10,29,34
D'or Fischer,Brose Baskets,4,92,15,24,0.625,0,0,,15,24,0.625,0.625,6,8,0.75,4,7,11,1,2,8,2,10,36
Dragan Milosavljevic,Partizan,14,448,64,147,0.435,22,64,0.344,42,83,0.506,0.51,20,30,0.667,20,32,52,23,13,4,31,41,170
Dusan Ristic,Crvena zvezda / Red Star,2,9,0,1,0,0,0,,0,1,0,0,2,2,1,0,2,2,0,0,0,1,1,2
Dusko Savanovic,Anadolu Efes,23,600,88,214,0.411,22,64,0.344,66,150,0.44,0.463,43,62,0.694,20,65,85,50,17,6,38,37,241
Earl Calloway,Unicaja Malaga,22,429,54,128,0.422,25,69,0.362,29,59,0.492,0.52,14,15,0.933,10,37,47,63,18,3,29,48,147
Eimantas Bendzius,Lietuvos rytas,2,18,1,5,0.2,0,3,0,1,2,0.5,0.2,0,0,,1,2,3,0,0,0,0,1,2
Emir Preldzic,Fenerbahçe,23,667,80,177,0.452,20,63,0.317,60,114,0.526,0.508,55,79,0.696,25,83,108,107,25,6,39,51,235
Emircan Kosut,Anadolu Efes,5,29,3,4,0.75,1,1,1,2,3,0.667,0.875,0,0,,0,2,2,1,0,2,2,4,7
Ender Arslan,Galatasaray,26,387,58,144,0.403,21,67,0.313,37,77,0.481,0.476,36,45,0.8,5,15,20,47,5,0,25,27,173
Engin Atsur,Galatasaray,3,22,0,8,0,0,3,0,0,5,0,0,0,0,,1,3,4,3,1,0,2,1,0
Erazem Lorbek,FC Barcelona Regal,19,369,62,128,0.484,13,40,0.325,49,88,0.557,0.535,15,27,0.556,15,36,51,12,2,3,14,27,152
Erick Green,Montepaschi Siena,10,244,45,107,0.421,12,36,0.333,33,71,0.465,0.477,9,13,0.692,3,14,17,10,8,1,7,16,111
Erving Walker,Zielona Góra,10,131,20,53,0.377,6,28,0.214,14,25,0.56,0.434,12,14,0.857,0,11,11,15,0,0,17,10,58
Erwin Dudley,Galatasaray,7,119,25,51,0.49,0,0,,25,51,0.49,0.49,5,8,0.625,7,22,29,4,2,2,4,11,55
Evgeny Voronov,CSKA Moscow,1,7,0,0,,0,0,,0,0,,,0,0,,0,0,0,0,2,0,0,1,0
Fabien Causeur,Laboral Kutxa,17,394,36,85,0.424,11,37,0.297,25,48,0.521,0.488,18,18,1,9,30,39,26,9,2,21,35,101
Felipe Reyes,Real Madrid,30,492,86,186,0.462,7,23,0.304,79,163,0.485,0.481,94,110,0.855,60,86,146,20,10,5,29,84,273
Fernando San Emeterio,Laboral Kutxa,21,561,71,143,0.497,30,69,0.435,41,74,0.554,0.601,23,29,0.793,16,43,59,45,7,0,33,29,195
Fran Vazquez,Unicaja Malaga,22,405,63,107,0.589,0,0,,63,107,0.589,0.589,16,23,0.696,46,52,98,13,11,25,19,56,142
Furkan Aldemir,Galatasaray,22,385,51,78,0.654,0,0,,51,78,0.654,0.654,17,33,0.515,53,87,140,17,10,21,18,46,119
Gani Lawal,EA7-Emporio Armani Milano,24,355,54,89,0.607,0,0,,54,89,0.607,0.607,43,60,0.717,41,54,95,2,5,23,18,50,151
Gasper Vidmar,Fenerbahçe,15,236,34,57,0.596,0,1,0,34,56,0.607,0.596,10,24,0.417,37,28,65,9,5,5,16,41,78
Gediminas Orelik,Lietuvos rytas,7,46,2,6,0.333,1,3,0.333,1,3,0.333,0.417,3,4,0.75,0,2,2,0,1,0,1,4,8
Giorgi Shermadini,Olympiacos,9,126,14,24,0.583,0,0,,14,24,0.583,0.583,21,27,0.778,9,22,31,4,0,0,5,16,49
Giorgos Apostolidis,Panathinaikos,1,5,0,1,0,0,0,,0,1,0,0,0,0,,0,0,0,0,0,0,2,0,0
Giorgos Printezis,Olympiacos,21,447,86,194,0.443,15,55,0.273,71,139,0.511,0.482,27,41,0.659,32,66,98,20,8,4,17,41,214
Giuseppe Poeta,Laboral Kutxa,10,130,11,26,0.423,5,12,0.417,6,14,0.429,0.519,12,14,0.857,6,10,16,11,5,0,8,9,39
Goksenin Koksal,Galatasaray,18,128,11,28,0.393,5,17,0.294,6,11,0.545,0.482,4,7,0.571,5,2,7,4,5,0,6,16,31
Grigory Shukhovtsov,CSKA Moscow,3,8,0,1,0,0,0,,0,1,0,0,1,2,0.5,0,1,1,0,0,0,1,2,1
Guy Pnini,Maccabi Tel Aviv,27,497,50,118,0.424,38,92,0.413,12,26,0.462,0.585,14,24,0.583,8,40,48,48,11,2,17,47,152
Heiko Schaffartzik,FC Bayern Munich,22,458,46,113,0.407,26,79,0.329,20,34,0.588,0.522,12,14,0.857,9,30,39,61,7,1,31,40,130
Henry Domercant,Galatasaray,27,367,43,129,0.333,22,71,0.31,21,58,0.362,0.419,19,21,0.905,7,26,33,11,16,0,15,30,127
Igor Kanygin,Lokomotiv Kuban,1,5,1,1,1,0,0,,1,1,1,1,0,0,,0,2,2,1,0,0,0,0,2
Ilimane Diop,Laboral Kutxa,14,136,13,25,0.52,0,1,0,13,24,0.542,0.52,10,18,0.556,12,21,33,2,3,6,6,19,36
Ioannis Papapetrou,Olympiacos,12,124,21,37,0.568,11,23,0.478,10,14,0.714,0.716,2,5,0.4,4,13,17,4,3,2,7,15,55
Ivan Radenovic,Crvena zvezda / Red Star,10,211,28,57,0.491,4,17,0.235,24,40,0.6,0.526,22,34,0.647,10,25,35,17,6,1,13,22,82
Izzet Turkyilmaz,Fenerbahçe,7,49,3,8,0.375,0,2,0,3,6,0.5,0.375,3,4,0.75,4,7,11,1,2,1,6,6,9
Jacob Pullen,FC Barcelona Regal,16,165,30,76,0.395,15,44,0.341,15,32,0.469,0.493,3,3,1,1,6,7,27,5,1,13,12,78
Jaka Blazic,Crvena zvezda / Red Star,10,197,36,78,0.462,10,29,0.345,26,49,0.531,0.526,21,28,0.75,13,20,33,11,9,2,14,30,103
Jake Cohen,Maccabi Tel Aviv,4,15,1,5,0.2,0,0,,1,5,0.2,0.2,0,0,,1,0,1,1,1,0,0,1,2
Jamar Smith,Brose Baskets,10,211,45,101,0.446,25,52,0.481,20,49,0.408,0.569,10,12,0.833,4,11,15,18,5,0,12,15,125
Jamario Moon,Olympiacos,1,7,0,3,0,0,3,0,0,0,,0,0,0,,0,0,0,0,0,0,1,2,0
James Birsen,Fenerbahçe,8,44,2,7,0.286,0,2,0,2,5,0.4,0.286,1,2,0.5,2,7,9,0,3,1,0,8,5
James Gist,Panathinaikos,26,608,90,167,0.539,13,38,0.342,77,129,0.597,0.578,39,62,0.629,34,60,94,21,29,18,42,50,232
Jamon Gordon,Anadolu Efes,21,670,90,216,0.417,10,33,0.303,80,183,0.437,0.44,17,26,0.654,16,52,68,110,42,10,43,57,207
Jamont Gordon,Galatasaray,4,137,14,41,0.341,7,19,0.368,7,22,0.318,0.427,10,11,0.909,3,13,16,19,3,0,10,9,45
Janis Strelnieks,BC Budivelnyk,10,225,29,57,0.509,13,28,0.464,16,29,0.552,0.623,10,10,1,3,11,14,26,9,0,14,14,81
Jaycee Carroll,Real Madrid,16,221,40,90,0.444,25,62,0.403,15,28,0.536,0.583,8,9,0.889,4,20,24,13,7,0,12,16,113
Jayson Granger,Unicaja Malaga,24,511,69,169,0.408,12,41,0.293,57,128,0.445,0.444,31,36,0.861,7,44,51,82,14,0,44,47,181
Jeffrey Viggiano,Montepaschi Siena,10,200,26,69,0.377,10,39,0.256,16,30,0.533,0.449,3,5,0.6,6,20,26,12,8,4,9,27,65
Je'Kel Foster,JSF Nanterre,10,153,19,50,0.38,8,27,0.296,11,23,0.478,0.46,3,3,1,5,12,17,17,8,0,7,21,49
Jeremy Leloup,Strasbourg IG,10,242,22,61,0.361,10,31,0.323,12,30,0.4,0.443,14,14,1,7,13,20,25,10,0,10,30,68
Jeremy Nzeulie,JSF Nanterre,10,157,9,29,0.31,5,14,0.357,4,15,0.267,0.397,2,3,0.667,4,11,15,8,3,0,6,21,25
Jeremy Pargo,CSKA Moscow,27,416,56,124,0.452,9,35,0.257,47,89,0.528,0.488,15,23,0.652,5,23,28,38,12,3,32,40,136
Joe Ingles,Maccabi Tel Aviv,30,687,70,147,0.476,30,73,0.411,40,74,0.541,0.578,23,33,0.697,13,78,91,88,23,2,38,56,193
Joey Dorsey,FC Barcelona Regal,29,444,64,96,0.667,0,0,,64,96,0.667,0.667,27,61,0.443,67,104,171,20,16,31,24,68,155
Joffrey Lauvergne,Partizan,24,775,101,197,0.513,8,35,0.229,93,162,0.574,0.533,55,77,0.714,70,136,206,24,14,6,45,50,265
Johan Passave-Ducteil,JSF Nanterre,9,141,15,34,0.441,0,0,,15,34,0.441,0.441,16,24,0.667,13,22,35,4,10,1,12,22,46
John Bryant,FC Bayern Munich,24,492,79,180,0.439,5,25,0.2,74,155,0.477,0.453,25,37,0.676,44,112,156,28,10,9,32,75,188
John Goldsberry,Brose Baskets,10,183,11,31,0.355,8,24,0.333,3,7,0.429,0.484,1,1,1,0,16,16,32,5,0,13,19,31
Jonas Maciulis,Panathinaikos,27,645,75,182,0.412,33,100,0.33,42,82,0.512,0.503,35,47,0.745,22,92,114,45,45,1,33,70,218
Jonathan Barreiro,Real Madrid,2,3,0,2,0,0,0,,0,2,0,0,1,1,1,0,1,1,0,1,0,0,0,1
Josh Carter,Montepaschi Siena,10,269,29,71,0.408,18,48,0.375,11,23,0.478,0.535,16,20,0.8,12,20,32,16,5,2,8,26,92
Juan Carlos Navarro,FC Barcelona Regal,26,624,95,236,0.403,46,133,0.346,49,103,0.476,0.5,59,68,0.868,5,38,43,81,12,0,34,34,295
Juan Palacios,Lietuvos rytas,10,254,37,91,0.407,0,7,0,37,84,0.44,0.407,26,35,0.743,18,37,55,13,8,11,13,34,100
Judson Wallace,EA7-Emporio Armani Milano,25,350,29,81,0.358,13,39,0.333,16,42,0.381,0.438,25,35,0.714,24,56,80,17,13,6,10,56,96
Justin Dentmon,BC Zalgiris,24,710,131,301,0.435,74,167,0.443,57,134,0.425,0.558,69,80,0.863,7,75,82,99,30,2,89,79,405
Kamil Chanas,Zielona Góra,8,61,7,16,0.438,2,7,0.286,5,9,0.556,0.5,3,3,1,2,1,3,0,1,0,4,14,19
Karsten Tadda,Brose Baskets,8,57,2,6,0.333,1,4,0.25,1,2,0.5,0.417,2,2,1,1,5,6,4,2,0,2,5,7
Kaspars Vecvagars,BC Zalgiris,8,85,8,19,0.421,2,9,0.222,6,10,0.6,0.474,2,3,0.667,1,3,4,9,2,0,7,11,20
Keith Langford,EA7-Emporio Armani Milano,25,748,136,314,0.433,48,132,0.364,88,182,0.484,0.51,119,156,0.763,24,60,84,72,16,0,52,49,439
Kenan Sipahi,Fenerbahçe,15,191,15,29,0.517,4,11,0.364,11,18,0.611,0.586,7,10,0.7,3,12,15,16,8,1,9,34,41
Kerem Gonlum,Anadolu Efes,17,333,44,79,0.557,0,1,0,44,78,0.564,0.557,18,38,0.474,26,55,81,6,9,5,17,29,106
Kevin Murphy,Strasbourg IG,5,95,11,33,0.333,2,6,0.333,9,27,0.333,0.364,5,7,0.714,1,9,10,4,2,1,9,8,29
Kim English,Montepaschi Siena,4,74,11,33,0.333,4,13,0.308,7,20,0.35,0.394,4,6,0.667,1,8,9,4,2,1,2,7,30
Kostas Papanikolaou,FC Barcelona Regal,28,700,77,152,0.507,22,61,0.361,55,91,0.604,0.579,18,36,0.5,24,72,96,61,21,15,39,52,194
Kostas Sloukas,Olympiacos,28,546,62,144,0.431,26,69,0.377,36,75,0.48,0.521,31,38,0.816,6,37,43,82,15,6,40,47,181
Kostiantyn Anikienko,BC Budivelnyk,2,2,0,0,,0,0,,0,0,,,2,2,1,0,0,0,0,0,0,0,0,2
Kristjan Kangur,EA7-Emporio Armani Milano,17,286,21,56,0.375,14,38,0.368,7,18,0.389,0.5,10,10,1,11,22,33,10,6,3,7,38,66
Krunoslav Simon,Lokomotiv Kuban,23,575,79,187,0.422,34,97,0.351,45,90,0.5,0.513,52,65,0.8,8,69,77,60,22,7,31,55,244
Ksistof Lavrinovic,BC Zalgiris,13,228,30,77,0.39,6,26,0.231,24,51,0.471,0.429,28,32,0.875,11,33,44,13,5,5,20,20,94
Kyle Hines,CSKA Moscow,29,571,91,145,0.628,0,1,0,91,144,0.632,0.628,39,57,0.684,52,79,131,33,25,22,22,64,221
Lamar Odom,Laboral Kutxa,1,6,0,1,0,0,1,0,0,0,,0,0,0,,0,2,2,0,0,1,1,2,0
Lamont Hamilton,Laboral Kutxa,12,226,42,102,0.412,14,31,0.452,28,71,0.394,0.48,25,38,0.658,17,27,44,16,13,12,19,18,123
Leo Mainoldi,Laboral Kutxa,22,315,26,79,0.329,20,55,0.364,6,24,0.25,0.456,2,4,0.5,8,34,42,12,10,1,3,37,74
Leo Westermann,Partizan,5,136,11,32,0.344,5,13,0.385,6,19,0.316,0.422,8,8,1,1,6,7,11,2,0,12,12,35
Linas Kleiza,Fenerbahçe,24,511,79,174,0.454,18,59,0.305,61,115,0.53,0.506,67,73,0.918,19,66,85,20,9,2,21,58,243
Louis Campbell,Strasbourg IG,10,277,29,76,0.382,16,42,0.381,13,34,0.382,0.487,6,11,0.545,6,18,24,42,10,1,26,16,80
Loukas Mavrokefalidis,Panathinaikos,26,203,44,79,0.557,1,5,0.2,43,74,0.581,0.563,34,42,0.81,14,22,36,13,6,2,17,38,123
Lucca Staiger,FC Bayern Munich,22,354,42,96,0.438,34,77,0.442,8,19,0.421,0.615,4,6,0.667,12,25,37,14,6,0,18,34,122
Luka Mitrovic,Crvena zvezda / Red Star,7,98,9,22,0.409,1,9,0.111,8,13,0.615,0.432,6,8,0.75,11,16,27,7,4,2,3,7,25
Luka Zoric,Fenerbahçe,24,454,84,151,0.556,0,1,0,84,150,0.56,0.556,30,39,0.769,33,53,86,4,5,14,42,66,198
Lukasz Koszarek,Zielona Góra,10,313,34,90,0.378,11,35,0.314,23,55,0.418,0.439,6,7,0.857,4,34,38,58,4,1,30,27,85
Maciej Kucharek,Zielona Góra,6,29,1,4,0.25,0,3,0,1,1,1,0.25,0,0,,1,1,2,1,1,0,3,6,2
Maciej Lampe,FC Barcelona Regal,19,274,53,104,0.51,6,17,0.353,47,87,0.54,0.538,21,29,0.724,19,44,63,13,4,8,15,34,133
Maik Zirbes,Brose Baskets,10,188,33,65,0.508,0,1,0,33,64,0.516,0.508,15,23,0.652,32,16,48,7,1,2,14,33,81
Malcolm Delaney,FC Bayern Munich,24,679,96,237,0.405,42,109,0.385,54,128,0.422,0.494,100,118,0.847,21,60,81,107,23,3,51,66,334
Malik Hairston,Galatasaray,21,588,69,161,0.429,7,28,0.25,62,133,0.466,0.45,32,47,0.681,26,27,53,34,8,6,32,48,177
Mantas Kalnietis,Lokomotiv Kuban,24,679,91,198,0.46,18,71,0.254,73,127,0.575,0.505,25,38,0.658,13,60,73,118,26,3,62,28,225
Manuchar Markoishvili,Galatasaray,10,256,29,66,0.439,17,41,0.415,12,25,0.48,0.568,4,7,0.571,6,19,25,17,9,1,13,35,79
Maodo Nguirane,Unicaja Malaga,4,3,0,0,,0,0,,0,0,,,0,0,,0,2,2,1,0,0,0,0,0
Marc Judith,JSF Nanterre,10,134,3,8,0.375,0,3,0,3,5,0.6,0.375,6,8,0.75,9,5,14,16,6,0,9,21,12
Marcelo Huertas,FC Barcelona Regal,29,624,92,187,0.492,25,74,0.338,67,113,0.593,0.559,30,37,0.811,12,47,59,109,11,1,50,34,239
Marcin Sroka,Zielona Góra,10,102,9,22,0.409,3,11,0.273,6,11,0.545,0.477,4,7,0.571,5,9,14,3,3,0,6,15,25
Marcus Slaughter,Real Madrid,31,384,42,61,0.689,0,2,0,42,59,0.712,0.689,16,34,0.471,26,47,73,15,18,9,16,66,100
Marcus Williams,Lokomotiv Kuban,24,552,59,176,0.335,27,98,0.276,32,78,0.41,0.412,31,41,0.756,7,46,53,92,8,1,37,35,176
Mardy Collins,Olympiacos,14,118,12,37,0.324,2,6,0.333,10,31,0.323,0.351,3,4,0.75,7,15,22,15,4,1,10,26,29
Mario Hezonja,FC Barcelona Regal,14,85,9,21,0.429,2,8,0.25,7,13,0.538,0.476,3,4,0.75,1,6,7,3,0,0,5,8,23
Marko Simonovic,Crvena zvezda / Red Star,10,194,17,42,0.405,12,32,0.375,5,10,0.5,0.548,2,3,0.667,7,22,29,6,8,2,2,14,48
Marko Tejic,Crvena zvezda / Red Star,1,15,2,3,0.667,0,1,0,2,2,1,0.667,0,0,,0,2,2,1,0,0,1,5,4
Marko Todorovic,FC Barcelona Regal,14,83,6,14,0.429,0,0,,6,14,0.429,0.429,6,7,0.857,5,14,19,1,3,2,3,16,18
MarQuez Haynes,EA7-Emporio Armani Milano,10,135,10,38,0.263,6,22,0.273,4,16,0.25,0.342,4,4,1,2,7,9,4,2,2,6,19,30
Martynas Gecevicius,Lietuvos rytas,10,291,39,88,0.443,27,61,0.443,12,27,0.444,0.597,19,24,0.792,1,26,27,20,12,0,21,18,124
Martynas Pocius,BC Zalgiris,20,464,72,173,0.416,34,95,0.358,38,78,0.487,0.514,40,52,0.769,16,42,58,49,8,2,30,44,218
Matt Lojeski,Olympiacos,29,725,118,229,0.515,43,100,0.43,75,129,0.581,0.609,42,54,0.778,22,93,115,58,18,3,35,42,321
Maxim Grigoryev,Lokomotiv Kuban,12,78,6,23,0.261,1,13,0.077,5,10,0.5,0.283,12,16,0.75,0,3,3,5,3,0,7,10,25
Maxim Kolyushkin,Lokomotiv Kuban,1,2,1,1,1,0,0,,1,1,1,1,0,0,,0,0,0,1,0,0,0,0,2
Melih Mahmutoglu,Fenerbahçe,22,319,43,96,0.448,22,53,0.415,21,43,0.488,0.563,12,13,0.923,5,22,27,14,12,0,10,36,120
Micah Downs,BC Budivelnyk,5,124,18,36,0.5,6,15,0.4,12,21,0.571,0.583,10,12,0.833,5,13,18,11,6,5,11,14,52
Michael Bramos,Panathinaikos,28,633,60,154,0.39,41,110,0.373,19,44,0.432,0.523,17,25,0.68,21,67,88,24,14,7,27,52,178
Michailis Anisimovas,BC Budivelnyk,8,132,9,25,0.36,0,0,,9,25,0.36,0.36,9,17,0.529,10,14,24,6,2,1,9,22,27
Miguel Cardoso,JSF Nanterre,1,5,1,2,0.5,0,1,0,1,1,1,0.5,0,0,,0,0,0,0,1,0,1,0,2
Mihajlo Andric,Partizan,16,174,9,21,0.429,4,14,0.286,5,7,0.714,0.524,4,4,1,3,7,10,10,6,0,4,21,26
Mike Batiste,Panathinaikos,27,224,38,82,0.463,1,6,0.167,37,76,0.487,0.47,18,26,0.692,8,33,41,10,4,1,21,32,95
Milan Macvan,Galatasaray,26,507,60,126,0.476,13,40,0.325,47,86,0.547,0.528,44,58,0.759,47,71,118,27,7,7,17,40,177
Milenko Tepic,Lietuvos rytas,9,141,16,46,0.348,4,18,0.222,12,28,0.429,0.391,2,2,1,3,11,14,13,4,0,8,8,38
Milenko Tepic,Partizan,13,385,32,75,0.427,8,25,0.32,24,50,0.48,0.48,8,9,0.889,5,27,32,26,10,0,25,30,80
Milko Bjelica,Anadolu Efes,14,318,50,109,0.459,10,37,0.27,40,72,0.556,0.505,21,23,0.913,13,22,35,17,9,1,21,30,131
Milko Bjelica,Laboral Kutxa,8,170,38,64,0.594,6,17,0.353,32,47,0.681,0.641,20,21,0.952,14,21,35,10,2,3,10,21,102
Milos Teodosic,CSKA Moscow,23,575,82,201,0.408,43,123,0.35,39,78,0.5,0.515,39,42,0.929,2,56,58,91,12,0,52,53,246
Mindaugas Kupsas,BC Zalgiris,15,110,17,31,0.548,0,0,,17,31,0.548,0.548,7,14,0.5,2,13,15,4,1,1,8,23,41
Mindaugas Kuzminskas,Unicaja Malaga,24,343,60,127,0.472,11,35,0.314,49,92,0.533,0.516,19,30,0.633,34,21,55,13,13,6,15,31,150
Mirza Begic,Olympiacos,12,100,19,35,0.543,0,0,,19,35,0.543,0.543,5,8,0.625,8,16,24,2,1,10,8,9,43
Mohamed Toure,EA7-Emporio Armani Milano,1,1,0,0,,0,0,,0,0,,,0,0,,0,0,0,0,0,0,0,0,0
Mouhammadou Jaiteh,JSF Nanterre,10,126,19,34,0.559,0,2,0,19,32,0.594,0.559,8,11,0.727,11,26,37,3,4,4,4,18,46
Nathan Jawai,Galatasaray,2,29,7,8,0.875,0,0,,7,8,0.875,0.875,8,11,0.727,0,5,5,1,1,1,2,2,22
Nemanja Bezbradica,Partizan,15,57,4,10,0.4,1,3,0.333,3,7,0.429,0.45,1,2,0.5,3,6,9,0,2,2,5,4,10
Nemanja Bjelica,Fenerbahçe,24,602,90,190,0.474,37,89,0.416,53,101,0.525,0.571,33,39,0.846,30,117,147,53,25,10,34,63,250
Nenad Krstic,CSKA Moscow,29,563,112,223,0.502,3,5,0.6,109,218,0.5,0.509,51,81,0.63,25,67,92,23,8,16,27,47,278
Nicolo Melli,EA7-Emporio Armani Milano,27,570,55,115,0.478,16,48,0.333,39,67,0.582,0.548,17,22,0.773,34,83,117,22,24,15,15,77,143
Nihad Djedovic,FC Bayern Munich,18,459,77,168,0.458,22,55,0.4,55,113,0.487,0.524,35,38,0.921,19,46,65,41,14,2,46,35,211
Nik Caner-Medley,Unicaja Malaga,20,526,93,188,0.495,24,63,0.381,69,125,0.552,0.559,39,51,0.765,32,67,99,17,14,11,26,16,249
Nikola Milutinov,Partizan,21,426,41,80,0.513,0,0,,41,80,0.513,0.513,16,25,0.64,38,32,70,20,4,12,16,69,98
Nikola Mirotic,Real Madrid,31,747,120,237,0.506,41,89,0.461,79,148,0.534,0.593,103,127,0.811,41,102,143,38,34,25,33,62,384
Nikos Pappas,Panathinaikos,13,111,21,45,0.467,5,13,0.385,16,32,0.5,0.522,15,20,0.75,4,7,11,6,4,1,8,17,62
Novica Velickovic,Brose Baskets,5,100,15,42,0.357,1,12,0.083,14,30,0.467,0.369,5,6,0.833,1,13,14,6,2,0,4,9,36
Oguz Savas,Fenerbahçe,3,40,8,13,0.615,0,0,,8,13,0.615,0.615,6,7,0.857,7,5,12,1,1,0,0,5,22
Oleksandr Nerush,BC Budivelnyk,2,6,1,2,0.5,0,0,,1,2,0.5,0.5,0,0,,1,0,1,1,0,0,0,0,2
Oleksandr Tishchenko,BC Budivelnyk,7,45,4,14,0.286,1,7,0.143,3,7,0.429,0.321,0,0,,6,7,13,3,2,2,3,11,9
Omar Cook,Lietuvos rytas,8,237,15,57,0.263,11,37,0.297,4,20,0.2,0.36,8,11,0.727,3,10,13,47,10,0,18,17,49
Omer Onan,Fenerbahçe,18,173,16,41,0.39,6,20,0.3,10,21,0.476,0.463,7,14,0.5,1,6,7,6,6,0,9,30,45
Othello Hunter,Montepaschi Siena,10,208,30,61,0.492,1,4,0.25,29,57,0.509,0.5,2,4,0.5,25,42,67,6,4,11,12,31,63
Paul Lacombe,Strasbourg IG,10,190,19,43,0.442,3,12,0.25,16,31,0.516,0.477,10,11,0.909,8,19,27,15,13,4,12,19,51
Paul Zipser,FC Bayern Munich,5,38,6,16,0.375,1,3,0.333,5,13,0.385,0.406,8,8,1,2,3,5,3,0,0,2,7,21
Paulius Dambrauskas,Lietuvos rytas,1,3,0,0,,0,0,,0,0,,,0,2,0,0,0,0,0,0,0,0,0,0
Paulius Jankunas,BC Zalgiris,21,548,74,159,0.465,9,35,0.257,65,124,0.524,0.494,26,33,0.788,38,98,136,40,24,7,35,55,183
Petar Aranitovic,Partizan,4,2,1,1,1,0,0,,1,1,1,1,0,0,,0,0,0,0,0,0,1,0,2
Philipp Neumann,Brose Baskets,6,54,8,13,0.615,0,1,0,8,12,0.667,0.615,6,8,0.75,5,1,6,1,0,3,5,6,22
Pierre Jackson,Fenerbahçe,6,49,5,15,0.333,0,4,0,5,11,0.455,0.333,10,14,0.714,0,8,8,8,2,0,5,7,20
Pops Mensah Bonsu,Galatasaray,18,385,60,105,0.571,0,2,0,60,103,0.583,0.571,31,53,0.585,44,73,117,9,8,7,18,44,151
Przemyslaw Zamojski,Zielona Góra,9,280,41,100,0.41,20,60,0.333,21,40,0.525,0.51,15,18,0.833,4,15,19,27,6,0,20,25,117
Rafael Hettsheimeir,Unicaja Malaga,17,224,31,64,0.484,10,24,0.417,21,40,0.525,0.563,15,21,0.714,10,21,31,5,5,3,13,24,87
Rakim Sanders,Brose Baskets,10,176,31,62,0.5,9,20,0.45,22,42,0.524,0.573,8,12,0.667,13,19,32,4,8,1,12,24,79
Ramel Curry,Panathinaikos,25,388,63,142,0.444,27,66,0.409,36,76,0.474,0.539,16,19,0.842,13,40,53,21,9,1,19,26,169
Rasko Katic,Crvena zvezda / Red Star,10,167,27,64,0.422,0,0,,27,64,0.422,0.422,22,34,0.647,12,16,28,6,5,2,15,34,76
Renaldas Seibutis,Lietuvos rytas,10,269,38,95,0.4,11,26,0.423,27,69,0.391,0.458,20,22,0.909,11,15,26,32,12,0,19,18,107
Ricardo Greer,Strasbourg IG,10,209,28,58,0.483,7,13,0.538,21,45,0.467,0.543,8,9,0.889,15,15,30,30,5,0,24,20,71
Richard Hendrix,Lokomotiv Kuban,23,550,101,175,0.577,1,4,0.25,100,171,0.585,0.58,39,56,0.696,59,108,167,44,14,26,39,69,242
Ricky Hickman,Maccabi Tel Aviv,30,861,121,275,0.44,30,93,0.323,91,182,0.5,0.495,94,125,0.752,11,67,78,82,24,2,53,73,366
Ricky Minard,BC Budivelnyk,10,233,30,81,0.37,6,12,0.5,24,69,0.348,0.407,17,26,0.654,6,27,33,29,14,1,15,22,83
Rimantas Kaukenas,Laboral Kutxa,5,63,7,17,0.412,0,5,0,7,12,0.583,0.412,4,4,1,5,2,7,4,4,0,5,5,18
Robertas Javtokas,BC Zalgiris,23,570,94,151,0.623,3,11,0.273,91,140,0.65,0.632,30,40,0.75,42,79,121,33,12,25,39,57,221
Robin Benzing,FC Bayern Munich,24,386,50,117,0.427,19,54,0.352,31,63,0.492,0.509,34,39,0.872,8,34,42,14,14,2,18,59,153
Roko Ukic,Panathinaikos,29,650,74,214,0.346,17,69,0.246,57,145,0.393,0.386,18,25,0.72,14,29,43,69,16,2,31,42,183
Romain Duport,Strasbourg IG,10,173,36,59,0.61,0,0,,36,59,0.61,0.61,5,7,0.714,13,25,38,4,3,10,12,18,77
Rudy Fernandez,Real Madrid,31,865,134,311,0.431,60,170,0.353,74,141,0.525,0.527,82,92,0.891,34,100,134,103,46,7,36,54,410
Ryan Toolson,Unicaja Malaga,19,363,50,129,0.388,21,57,0.368,29,72,0.403,0.469,16,17,0.941,2,19,21,19,5,1,19,29,137
Salah Mejri,Real Madrid,26,260,38,64,0.594,2,3,0.667,36,61,0.59,0.609,12,22,0.545,25,50,75,2,11,29,11,39,90
Samardo Samuels,EA7-Emporio Armani Milano,25,555,90,179,0.503,4,9,0.444,86,170,0.506,0.514,54,74,0.73,42,56,98,5,11,8,39,55,238
Sarunas Jasikevicius,BC Zalgiris,20,338,47,115,0.409,19,47,0.404,28,68,0.412,0.491,21,21,1,4,18,22,62,8,1,52,28,134
Sasha Kaun,CSKA Moscow,30,552,101,144,0.701,0,0,,101,144,0.701,0.701,49,83,0.59,40,65,105,14,24,23,18,57,251
Sasha Pavlovic,Partizan,7,185,32,81,0.395,7,21,0.333,25,60,0.417,0.438,9,11,0.818,5,18,23,12,8,0,12,21,80
Scotty Hopson,Anadolu Efes,11,314,65,104,0.625,15,31,0.484,50,73,0.685,0.697,25,34,0.735,11,35,46,12,14,5,25,25,170
Semih Erden,Anadolu Efes,17,366,41,97,0.423,0,0,,41,97,0.423,0.423,31,56,0.554,22,58,80,14,9,17,20,32,113
Sergey Bykov,Lokomotiv Kuban,10,178,24,54,0.444,3,8,0.375,21,46,0.457,0.472,6,11,0.545,2,13,15,25,10,2,15,28,57
Sergey Gladyr,JSF Nanterre,5,131,13,39,0.333,6,24,0.25,7,15,0.467,0.41,0,1,0,3,12,15,6,6,2,12,8,32
Sergi Vidal,Unicaja Malaga,18,209,14,38,0.368,5,20,0.25,9,18,0.5,0.434,10,13,0.769,6,13,19,24,5,0,4,17,43
Sergio Llull,Real Madrid,31,905,132,283,0.466,51,150,0.34,81,133,0.609,0.557,39,49,0.796,10,47,57,125,21,1,32,55,354
Sergio Rodriguez,Real Madrid,31,694,144,285,0.505,69,138,0.5,75,147,0.51,0.626,77,85,0.906,8,53,61,151,36,2,76,53,434
Sergiy Gorbenko,BC Budivelnyk,10,60,2,12,0.167,1,11,0.091,1,1,1,0.208,2,2,1,2,5,7,2,0,0,1,9,7
Sharrod Ford,Brose Baskets,7,158,25,58,0.431,3,17,0.176,22,41,0.537,0.457,8,12,0.667,21,32,53,3,2,4,15,19,61
Shawn James,Maccabi Tel Aviv,10,175,43,63,0.683,1,1,1,42,62,0.677,0.69,11,18,0.611,13,20,33,13,7,13,6,27,98
Siim Sander Vene,BC Zalgiris,5,69,6,13,0.462,1,2,0.5,5,11,0.455,0.5,2,2,1,3,10,13,3,1,1,3,5,15
Simas Jasaitis,Lokomotiv Kuban,23,495,55,123,0.447,24,69,0.348,31,54,0.574,0.545,9,9,1,19,45,64,14,15,3,16,44,143
Sinan Guler,Galatasaray,26,330,35,85,0.412,8,31,0.258,27,54,0.5,0.459,14,18,0.778,6,29,35,26,9,3,18,48,92
Sofoklis Schortsanitis,Maccabi Tel Aviv,29,412,111,181,0.613,0,0,,111,181,0.613,0.613,56,97,0.577,31,44,75,32,21,9,66,95,278
Sonny Weems,CSKA Moscow,29,824,133,301,0.442,35,99,0.354,98,202,0.485,0.5,52,69,0.754,16,85,101,106,24,6,50,56,353
Spencer Nelson,Montepaschi Siena,5,102,13,30,0.433,4,12,0.333,9,18,0.5,0.5,3,3,1,13,21,34,5,3,1,5,7,33
Stanko Barac,Anadolu Efes,6,82,10,20,0.5,0,0,,10,20,0.5,0.5,4,7,0.571,5,9,14,3,1,1,3,14,24
Steffen Hamann,FC Bayern Munich,12,82,1,7,0.143,0,3,0,1,4,0.25,0.143,2,4,0.5,0,6,6,16,0,0,7,14,4
Stephane Lasme,Panathinaikos,28,591,85,165,0.515,0,1,0,85,164,0.518,0.515,80,97,0.825,52,81,133,17,21,28,45,98,250
Steponas Babrauskas,Lietuvos rytas,10,169,12,34,0.353,6,23,0.261,6,11,0.545,0.441,12,15,0.8,5,15,20,9,13,0,10,28,42
Stevan Jelovac,Lietuvos rytas,10,136,24,58,0.414,5,26,0.192,19,32,0.594,0.457,8,13,0.615,4,19,23,3,6,1,12,18,61
Stratos Perperoglou,Olympiacos,22,447,77,168,0.458,30,65,0.462,47,103,0.456,0.548,34,40,0.85,10,51,61,26,16,0,22,40,218
Sylven Landesberg,Maccabi Tel Aviv,19,162,21,46,0.457,4,15,0.267,17,31,0.548,0.5,15,19,0.789,5,18,23,3,4,0,10,16,61
Tadas Klimavicius,BC Zalgiris,22,304,38,88,0.432,2,18,0.111,36,70,0.514,0.443,14,23,0.609,32,49,81,26,6,9,21,24,92
Tadija Dragicevic,Anadolu Efes,10,154,20,47,0.426,10,27,0.37,10,20,0.5,0.532,12,14,0.857,2,17,19,6,4,2,10,10,62
Tarence Kinsey,Partizan,16,506,85,198,0.429,11,31,0.355,74,167,0.443,0.457,55,67,0.821,11,62,73,26,29,6,31,32,236
Tauras Jogela,BC Zalgiris,1,1,0,1,0,0,0,,0,1,0,0,0,0,,0,0,0,0,0,0,0,0,0
Tautvydas Lydeka,Lietuvos rytas,7,82,7,13,0.538,0,0,,7,13,0.538,0.538,2,7,0.286,8,4,12,1,0,0,4,13,16
Taylor Rochestie,Montepaschi Siena,10,167,25,62,0.403,9,23,0.391,16,39,0.41,0.476,6,7,0.857,4,11,15,17,5,0,14,23,65
Thomas Heurtel,Laboral Kutxa,21,542,67,155,0.432,12,51,0.235,55,104,0.529,0.471,22,28,0.786,7,38,45,112,16,0,49,21,168
Thomas Kelati,Laboral Kutxa,7,129,11,20,0.55,6,13,0.462,5,7,0.714,0.7,2,6,0.333,2,18,20,8,9,0,4,19,30
Tibor Pleiss,Laboral Kutxa,24,504,112,203,0.552,0,0,,112,203,0.552,0.552,63,73,0.863,44,86,130,12,11,22,38,70,287
Tim Abromaitis,Strasbourg IG,10,186,30,62,0.484,8,24,0.333,22,38,0.579,0.548,7,12,0.583,15,17,32,8,5,2,10,21,75
Tomas Dimsa,BC Zalgiris,15,230,19,48,0.396,9,22,0.409,10,26,0.385,0.49,8,11,0.727,11,13,24,9,3,2,9,30,55
Tomas Ress,Montepaschi Siena,10,210,15,46,0.326,10,27,0.37,5,19,0.263,0.435,2,3,0.667,6,23,29,8,4,3,7,18,42
Tremmell Darden,Real Madrid,31,617,67,146,0.459,26,57,0.456,41,89,0.461,0.548,18,25,0.72,13,66,79,25,10,17,12,39,178
Trent Meacham,JSF Nanterre,10,322,33,91,0.363,15,48,0.313,18,43,0.419,0.445,6,6,1,3,24,27,41,8,1,12,20,87
Txemi Urtasun,Unicaja Malaga,9,120,14,42,0.333,7,18,0.389,7,24,0.292,0.417,17,20,0.85,4,8,12,8,1,0,12,8,52
Tyrese Rice,Maccabi Tel Aviv,30,618,96,235,0.409,26,68,0.382,70,167,0.419,0.464,68,80,0.85,5,59,64,95,18,2,35,66,286
Valeri Likhodei,Lokomotiv Kuban,21,313,42,87,0.483,35,64,0.547,7,23,0.304,0.684,5,11,0.455,14,28,42,4,4,8,9,32,124
Vangelis Mantzaris,Olympiacos,29,684,43,111,0.387,28,77,0.364,15,34,0.441,0.514,17,28,0.607,17,82,99,93,20,0,26,76,131
Vassilis Charalampopoulos,Panathinaikos,1,2,0,0,,0,0,,0,0,,,0,0,,0,1,1,0,0,0,1,0,0
Vassilis Kavvadas,Olympiacos,5,26,5,9,0.556,0,0,,5,9,0.556,0.556,1,3,0.333,3,4,7,0,0,0,1,5,11
Vassilis Spanoulis,Olympiacos,26,731,132,307,0.43,52,151,0.344,80,156,0.513,0.515,76,103,0.738,7,45,52,119,10,0,81,55,392
Victor Sada,FC Barcelona Regal,28,414,36,73,0.493,2,15,0.133,34,58,0.586,0.507,14,24,0.583,16,52,68,69,10,1,33,30,88
Viktor Khryapa,CSKA Moscow,28,666,70,146,0.479,25,64,0.391,45,82,0.549,0.565,18,27,0.667,18,132,150,119,25,12,49,64,183
Vitaly Fridzon,CSKA Moscow,31,555,78,150,0.52,47,94,0.5,31,56,0.554,0.677,29,34,0.853,9,39,48,33,14,3,20,71,232
Vladimir Dragicevic,Zielona Góra,10,279,66,103,0.641,0,1,0,66,102,0.647,0.641,15,26,0.577,24,43,67,15,6,9,15,25,147
Vladimir Jankovic,Panathinaikos,17,60,3,12,0.25,2,8,0.25,1,4,0.25,0.333,3,6,0.5,2,9,11,4,3,1,2,16,11
Vladimir Micov,CSKA Moscow,31,642,83,180,0.461,39,81,0.481,44,99,0.444,0.569,35,45,0.778,17,72,89,39,15,6,33,48,240
Vladimir Stimac,Unicaja Malaga,23,396,76,126,0.603,0,2,0,76,124,0.613,0.603,22,42,0.524,47,71,118,14,7,9,18,41,174
Vytenis Cizauskas,BC Zalgiris,16,142,15,30,0.5,5,12,0.417,10,18,0.556,0.583,1,4,0.25,3,14,17,19,7,0,16,24,36
Vytenis Lipkevicius,BC Zalgiris,23,488,35,80,0.438,11,25,0.44,24,55,0.436,0.506,26,31,0.839,19,40,59,16,10,0,29,47,107
Walter Hodge,Laboral Kutxa,15,314,42,100,0.42,12,40,0.3,30,60,0.5,0.48,21,23,0.913,4,15,19,46,6,2,25,35,117
Will Daniels,JSF Nanterre,10,213,43,96,0.448,10,26,0.385,33,70,0.471,0.5,19,29,0.655,18,29,47,7,6,5,15,25,115
Xavier Corosine,JSF Nanterre,8,84,6,17,0.353,2,9,0.222,4,8,0.5,0.412,2,4,0.5,0,5,5,1,3,0,4,10,16
Yassin Idbihi,FC Bayern Munich,23,315,51,96,0.531,0,3,0,51,93,0.548,0.531,16,27,0.593,42,38,80,9,5,6,22,49,118
Ioannis Bourousis,Real Madrid,29,612,86,163,0.528,12,34,0.353,74,129,0.574,0.564,58,71,0.817,52,121,173,25,11,23,28,63,242
Yogev Ohayon,Maccabi Tel Aviv,27,551,61,138,0.442,18,47,0.383,43,91,0.473,0.507,14,19,0.737,5,50,55,89,21,3,36,57,154
Zabian Dowdell,Lietuvos rytas,3,69,16,26,0.615,0,3,0,16,23,0.696,0.615,4,4,1,0,8,8,9,4,0,4,3,36
Zack Wright,Brose Baskets,10,189,24,54,0.444,0,0,,24,54,0.444,0.444,18,27,0.667,5,27,32,34,6,3,15,29,66
Zoran Dragic,Unicaja Malaga,22,504,83,201,0.413,28,79,0.354,55,122,0.451,0.483,45,64,0.703,28,31,59,35,16,2,26,43,239
Zoran Erceg,Galatasaray,25,688,90,225,0.4,37,111,0.333,53,114,0.465,0.482,62,67,0.925,24,98,122,41,16,4,19,46,279
Zoran Planinic,Anadolu Efes,23,541,74,188,0.394,17,57,0.298,57,131,0.435,0.439,28,38,0.737,9,47,56,85,20,1,45,70,193