Player,Team,G,MP,FG,FGA,FG%,3P,3PA,3P%,2P,2PA,2P%,eFG%,FT,FTA,FT%,ORB,DRB,TRB,AST,STL,BLK,TOV,PF,PTS
Adam Hrycaniuk,Asseco Prokom,9,73,7,14,0.5,0,1,0,7,13,0.538,0.5,8,8,1,4,20,24,4,1,0,4,14,22
Adam Lapeta,Asseco Prokom,10,140,8,23,0.348,0,0,,8,23,0.348,0.348,7,17,0.412,14,23,37,1,1,10,7,20,23
Alan Anderson,Regal FC Barcelona,10,272,39,87,0.448,15,33,0.455,24,54,0.444,0.534,21,25,0.84,5,26,31,15,6,2,16,24,114
Aleks Maric,Panathinaikos,8,61,10,18,0.556,0,0,,10,18,0.556,0.556,8,12,0.667,14,14,28,0,5,3,5,10,28
Aleksandar Capin,BC Zalgiris,5,43,6,11,0.545,1,2,0.5,5,9,0.556,0.591,4,4,1,2,7,9,6,1,0,3,4,17
Alessandro Tonolli,Lottomatica Roma,4,9,1,3,0.333,0,1,0,1,2,0.5,0.333,0,0,,0,0,0,0,0,0,0,0,2
Alexey Savrasenko,BC Khimki,10,121,15,22,0.682,0,0,,15,22,0.682,0.682,3,11,0.273,18,19,37,2,3,4,7,24,33
Alexey Shved,CSKA Moscow,7,86,11,20,0.55,4,9,0.444,7,11,0.636,0.65,5,6,0.833,3,7,10,8,2,1,11,9,31
Ali Traore,Lottomatica Roma,15,288,56,100,0.56,0,1,0,56,99,0.566,0.56,30,41,0.732,20,37,57,5,8,9,21,31,142
Aloysius Anagonye,KK Union Olimpija,5,32,4,9,0.444,0,0,,4,9,0.444,0.444,4,7,0.571,6,5,11,2,2,0,3,6,12
Ander Garcia,Caja Laboral,1,3,0,1,0,0,0,,0,1,0,0,0,0,,0,0,0,0,0,0,1,0,0
Andre Riddick,Spirou Charleroi,10,167,21,35,0.6,0,0,,21,35,0.6,0.6,8,21,0.381,20,30,50,6,4,14,9,25,50
Andrea Crosariol,Lottomatica Roma,16,355,40,75,0.533,0,1,0,40,74,0.541,0.533,19,30,0.633,26,54,80,14,13,15,31,43,99
Andrea Iannilli,Lottomatica Roma,2,15,0,3,0,0,0,,0,3,0,0,1,2,0.5,1,4,5,0,0,0,4,4,1
Andrea Michelori,Montepaschi Siena,16,109,10,20,0.5,0,0,,10,20,0.5,0.5,13,20,0.65,14,10,24,1,2,0,8,21,33
Andreas Glyniadakis,Olympiacos,3,19,2,8,0.25,0,0,,2,8,0.25,0.25,4,6,0.667,1,1,2,0,0,0,1,3,8
Andrew Wisniewski,Efes Pilsen,15,326,25,59,0.424,8,24,0.333,17,35,0.486,0.492,10,12,0.833,4,14,18,29,8,1,14,45,68
Andrey Vorontsevich,CSKA Moscow,10,239,38,68,0.559,20,35,0.571,18,33,0.545,0.706,9,13,0.692,13,30,43,11,6,3,18,21,105
Angel Aparicio,Regal FC Barcelona,3,5,0,1,0,0,0,,0,1,0,0,0,0,,0,1,1,1,0,0,1,0,0
Angel Garcia,Unicaja Malaga,1,3,0,2,0,0,2,0,0,0,,0,0,0,,0,0,0,0,0,0,1,0,0
Angelo Gigli,Lottomatica Roma,2,37,2,5,0.4,0,1,0,2,4,0.5,0.4,0,0,,1,0,1,0,0,0,2,5,4
Ante Tomic,Real Madrid,23,485,96,191,0.503,0,0,,96,191,0.503,0.503,36,54,0.667,46,77,123,25,14,13,38,64,228
Anton Gavel,Brose Baskets,10,308,33,76,0.434,11,33,0.333,22,43,0.512,0.507,6,7,0.857,5,16,21,19,6,0,8,24,83
Antonis Fotsis,Panathinaikos,22,532,62,117,0.53,27,71,0.38,35,46,0.761,0.645,33,51,0.647,32,81,113,18,18,15,15,46,184
Antywane Robinson,Cholet Basket,10,255,45,113,0.398,8,27,0.296,37,86,0.43,0.434,9,12,0.75,27,31,58,3,5,7,12,20,107
Arturas Jomantas,Lietuvos rytas,12,202,10,31,0.323,3,14,0.214,7,17,0.412,0.371,6,8,0.75,4,22,26,12,5,1,11,22,29
Arturas Milaknis,BC Zalgiris,15,233,21,57,0.368,12,39,0.308,9,18,0.5,0.474,4,5,0.8,3,12,15,6,10,0,16,23,58
Arvydas Siksnius,Lietuvos rytas,6,23,1,3,0.333,0,2,0,1,1,1,0.333,2,2,1,0,2,2,2,2,0,0,6,4
Augusto Lima,Unicaja Malaga,7,68,10,19,0.526,0,0,,10,19,0.526,0.526,0,1,0,7,15,22,1,3,4,3,14,20
Benjamin Eze,BC Khimki,10,222,35,69,0.507,0,0,,35,69,0.507,0.507,11,20,0.55,12,31,43,2,5,14,15,25,81
Berni Rodriguez,Unicaja Malaga,16,382,40,97,0.412,25,54,0.463,15,43,0.349,0.541,13,16,0.813,4,18,22,58,10,1,21,36,118
Billy Baptist,Unicaja Malaga,2,11,1,2,0.5,0,1,0,1,1,1,0.5,0,0,,0,1,1,0,0,0,1,1,2
Bo McCalebb,Montepaschi Siena,15,314,61,111,0.55,7,16,0.438,54,95,0.568,0.581,44,50,0.88,16,14,30,32,27,0,19,25,173
Boban Marjanovic,CSKA Moscow,8,93,11,24,0.458,0,0,,11,24,0.458,0.458,12,13,0.923,12,16,28,3,5,5,7,17,34
Boban Marjanovic,BC Zalgiris,6,75,11,17,0.647,0,0,,11,17,0.647,0.647,9,14,0.643,6,15,21,2,1,3,11,9,31
Bobby Brown,Asseco Prokom,6,156,22,66,0.333,6,24,0.25,16,42,0.381,0.379,14,16,0.875,0,6,6,11,5,1,20,7,64
Bojan Bogdanovic,Cibona Zagreb,10,355,62,151,0.411,17,55,0.309,45,96,0.469,0.467,39,51,0.765,15,20,35,18,17,2,33,21,180
Boniface N'Dong,Regal FC Barcelona,20,240,50,74,0.676,0,0,,50,74,0.676,0.676,36,52,0.692,22,30,52,1,4,8,15,41,136
Bootsy Thornton,Efes Pilsen,16,454,48,102,0.471,16,42,0.381,32,60,0.533,0.549,26,29,0.897,25,64,89,18,16,2,18,41,138
Bostjan Nachbar,Efes Pilsen,15,290,38,91,0.418,11,29,0.379,27,62,0.435,0.478,37,45,0.822,11,31,42,5,6,4,24,41,124
Brad Newley,Lietuvos rytas,15,377,42,101,0.416,11,33,0.333,31,68,0.456,0.47,17,24,0.708,20,41,61,21,9,10,17,33,112
Brad Oleson,Caja Laboral,20,420,46,113,0.407,17,52,0.327,29,61,0.475,0.482,16,20,0.8,10,33,43,21,12,4,20,50,125
Branislav Djekic,Partizan,9,84,7,17,0.412,3,8,0.375,4,9,0.444,0.5,3,4,0.75,2,12,14,1,2,0,5,12,20
Brent Wright,Spirou Charleroi,10,258,37,91,0.407,2,10,0.2,35,81,0.432,0.418,24,34,0.706,16,38,54,15,7,0,32,27,100
Brian Greene,Spirou Charleroi,10,197,30,77,0.39,13,35,0.371,17,42,0.405,0.474,14,16,0.875,6,24,30,15,10,2,10,21,87
Brian Roberts,Brose Baskets,10,237,39,95,0.411,12,40,0.3,27,55,0.491,0.474,38,41,0.927,3,20,23,23,9,0,16,20,128
Can Maxim Mutaf,Fenerbahçe,3,28,1,6,0.167,0,4,0,1,2,0.5,0.167,2,2,1,1,2,3,1,1,0,3,5,4
Carlos De Cobos,Unicaja Malaga,2,12,0,2,0,0,1,0,0,1,0,0,0,0,,0,0,0,1,0,0,0,1,0
Carlos Jimenez,Unicaja Malaga,11,238,21,52,0.404,14,35,0.4,7,17,0.412,0.538,12,15,0.8,10,37,47,6,9,2,10,33,68
Carlos Suarez,Real Madrid,23,541,44,121,0.364,25,76,0.329,19,45,0.422,0.467,36,45,0.8,24,74,98,39,12,2,21,39,149
Casey Jacobsen,Brose Baskets,10,317,28,70,0.4,20,47,0.426,8,23,0.348,0.543,15,22,0.682,4,37,41,25,6,1,17,14,91
Cemal Nalga,Lietuvos rytas,14,204,33,47,0.702,0,0,,33,47,0.702,0.702,13,26,0.5,20,25,45,6,6,9,12,33,79
Cenk Akyol,Efes Pilsen,4,13,2,4,0.5,0,2,0,2,2,1,0.5,0,1,0,0,0,0,2,0,0,0,3,4
Charles Smith,Lottomatica Roma,13,315,30,97,0.309,18,65,0.277,12,32,0.375,0.402,5,10,0.5,5,18,23,19,24,6,17,30,83
Chris Hill,Spirou Charleroi,9,185,29,80,0.363,9,39,0.231,20,41,0.488,0.419,14,20,0.7,10,20,30,10,10,0,16,21,81
Christophe Beghin,Spirou Charleroi,4,38,2,9,0.222,0,0,,2,9,0.222,0.222,1,2,0.5,1,4,5,1,2,0,2,6,5
Christophe Leonard,Cholet Basket,8,113,15,25,0.6,2,3,0.667,13,22,0.591,0.64,4,4,1,9,12,21,3,2,1,7,14,36
Chuck Eidson,Maccabi Tel Aviv,22,645,76,175,0.434,19,56,0.339,57,119,0.479,0.489,43,61,0.705,28,67,95,78,57,3,33,40,214
Claude Marquis,Cholet Basket,10,163,27,55,0.491,0,1,0,27,54,0.5,0.491,11,21,0.524,21,15,36,2,4,2,16,28,65
Clay Tucker,Real Madrid,23,538,76,211,0.36,25,86,0.291,51,125,0.408,0.419,22,29,0.759,6,46,52,39,12,5,29,49,199
Courtney Eldridge,Asseco Prokom,4,54,2,11,0.182,1,3,0.333,1,8,0.125,0.227,3,6,0.5,0,1,1,5,0,0,6,8,8
Curtis Jerrells,Partizan,10,263,31,97,0.32,5,38,0.132,26,59,0.441,0.345,30,36,0.833,4,28,32,38,13,1,20,13,97
Dainius Salenga,BC Zalgiris,10,202,16,47,0.34,4,15,0.267,12,32,0.375,0.383,12,14,0.857,6,10,16,11,6,1,2,18,48
Damir Markota,KK Union Olimpija,15,395,46,114,0.404,14,51,0.275,32,63,0.508,0.465,21,29,0.724,23,44,67,29,11,2,28,26,127
Daniel Ewing,Asseco Prokom,10,305,48,117,0.41,10,35,0.286,38,82,0.463,0.453,22,23,0.957,2,23,25,34,14,1,25,16,128
Daniel Santiago,Spirou Charleroi,9,119,20,42,0.476,0,0,,20,42,0.476,0.476,11,18,0.611,7,23,30,3,5,3,8,24,51
Darius Washington,Lottomatica Roma,16,424,77,152,0.507,9,30,0.3,68,122,0.557,0.536,45,53,0.849,13,35,48,31,17,0,34,44,208
Darjus Lavrinovic,Fenerbahçe,16,347,43,101,0.426,7,31,0.226,36,70,0.514,0.46,35,45,0.778,19,52,71,20,12,15,22,48,128
David Bluthenthal,Maccabi Tel Aviv,22,506,73,163,0.448,41,96,0.427,32,67,0.478,0.574,8,11,0.727,19,50,69,13,17,2,22,51,195
David Hawkins,Armani Jeans Milano,10,292,44,104,0.423,12,42,0.286,32,62,0.516,0.481,30,34,0.882,4,26,30,30,18,1,14,31,130
David Logan,Caja Laboral,19,435,66,159,0.415,33,83,0.398,33,76,0.434,0.519,25,34,0.735,5,26,31,46,15,1,28,24,190
David Moss,Montepaschi Siena,22,471,62,130,0.477,14,31,0.452,48,99,0.485,0.531,29,36,0.806,17,35,52,40,30,8,36,66,167
David Navarro,Valencia Basket,7,31,3,3,1,1,1,1,2,2,1,1.167,2,2,1,2,3,5,1,1,0,4,4,9
Dejan Musli,Caja Laboral,2,2,0,1,0,0,0,,0,1,0,0,1,2,0.5,2,0,2,0,0,0,1,5,1
DeJuan Collins,BC Zalgiris,16,326,29,70,0.414,8,24,0.333,21,46,0.457,0.471,41,49,0.837,8,24,32,35,21,1,40,30,107
DeMarcus Nelson,Cholet Basket,10,256,33,78,0.423,5,16,0.313,28,62,0.452,0.455,21,33,0.636,10,23,33,15,5,3,28,32,92
Demond Mallet,Spirou Charleroi,10,314,44,95,0.463,21,56,0.375,23,39,0.59,0.574,23,24,0.958,4,23,27,33,11,0,21,26,132
Derrick Sharp,Maccabi Tel Aviv,13,21,3,7,0.429,1,3,0.333,2,4,0.5,0.5,2,3,0.667,1,2,3,0,0,0,2,3,9
Dimitri Sokolov,CSKA Moscow,10,222,31,44,0.705,0,1,0,31,43,0.721,0.705,23,40,0.575,18,36,54,5,3,7,14,33,85
Dimitrios Katsivelis,Olympiacos,2,18,2,3,0.667,1,2,0.5,1,1,1,0.833,2,2,1,0,2,2,3,0,0,2,3,7
Dimitris Diamantidis,Panathinaikos,22,671,72,166,0.434,37,100,0.37,35,66,0.53,0.545,95,109,0.872,18,67,85,131,36,3,67,57,276
Dino Muric,KK Union Olimpija,6,34,3,4,0.75,0,0,,3,4,0.75,0.75,0,0,,1,3,4,1,1,0,2,5,6
D.J. Strawberry,Lietuvos rytas,5,86,12,30,0.4,5,12,0.417,7,18,0.389,0.483,4,6,0.667,0,6,6,14,2,1,12,8,33
D'or Fischer,Real Madrid,23,426,58,102,0.569,0,0,,58,102,0.569,0.569,27,31,0.871,63,72,135,10,12,33,20,59,143
Doron Perkins,Maccabi Tel Aviv,19,557,61,152,0.401,17,67,0.254,44,85,0.518,0.457,42,65,0.646,22,81,103,69,32,10,33,55,181
Dragan Milosavljevic,Partizan,16,304,24,63,0.381,6,27,0.222,18,36,0.5,0.429,13,20,0.65,10,21,31,13,10,2,28,42,67
Drago Pasalic,Cibona Zagreb,7,166,25,57,0.439,4,17,0.235,21,40,0.525,0.474,10,12,0.833,10,23,33,3,0,0,14,22,64
Drew Nicholas,Panathinaikos,20,460,75,176,0.426,34,82,0.415,41,94,0.436,0.523,12,20,0.6,2,21,23,34,8,1,19,38,196
Dusan Kecman,Partizan,16,408,42,108,0.389,10,52,0.192,32,56,0.571,0.435,29,35,0.829,28,35,63,29,10,1,29,53,123
Dusko Savanovic,Valencia Basket,21,533,91,202,0.45,27,74,0.365,64,128,0.5,0.517,40,47,0.851,28,68,96,22,16,8,31,34,249
Dwayne Broyles,Spirou Charleroi,10,182,16,44,0.364,4,16,0.25,12,28,0.429,0.409,14,19,0.737,7,13,20,13,10,0,12,17,50
Elishay Kadir,Maccabi Tel Aviv,1,4,0,1,0,0,0,,0,1,0,0,0,0,,0,1,1,0,0,0,1,0,0
Emir Preldzic,Fenerbahçe,16,261,42,85,0.494,14,32,0.438,28,53,0.528,0.576,19,28,0.679,6,33,39,36,4,4,20,27,117
Ender Arslan,Efes Pilsen,8,71,5,19,0.263,1,11,0.091,4,8,0.5,0.289,9,12,0.75,3,2,5,8,2,0,2,9,20
Erazem Lorbek,Regal FC Barcelona,20,424,65,127,0.512,13,35,0.371,52,92,0.565,0.563,26,36,0.722,24,49,73,18,17,6,13,26,169
Erbil Eroglu,Fenerbahçe,2,12,0,1,0,0,0,,0,1,0,0,0,2,0,0,2,2,2,1,0,2,2,0
Erwin Dudley,Efes Pilsen,3,34,4,13,0.308,0,0,,4,13,0.308,0.308,4,4,1,3,4,7,1,1,0,3,6,12
Esteban Batista,Caja Laboral,10,197,32,60,0.533,0,1,0,32,59,0.542,0.533,20,28,0.714,26,37,63,14,5,3,24,31,84
Fabien Causeur,Cholet Basket,4,117,11,29,0.379,4,15,0.267,7,14,0.5,0.448,9,14,0.643,4,10,14,9,4,0,8,12,35
Fedor Dmitriev,BC Khimki,5,19,3,7,0.429,2,4,0.5,1,3,0.333,0.571,2,4,0.5,1,2,3,0,0,0,0,1,10
Felipe Reyes,Real Madrid,21,401,62,147,0.422,2,10,0.2,60,137,0.438,0.429,57,68,0.838,53,63,116,19,9,5,33,61,183
Fernando San Emeterio,Caja Laboral,20,676,95,167,0.569,30,60,0.5,65,107,0.607,0.659,54,70,0.771,24,85,109,47,16,1,30,35,274
Filip Videnov,Asseco Prokom,10,206,30,68,0.441,14,34,0.412,16,34,0.471,0.544,4,8,0.5,7,18,25,12,9,0,11,23,78
Florent Pietrus,Valencia Basket,20,282,19,36,0.528,0,6,0,19,30,0.633,0.528,24,29,0.828,24,27,51,4,10,5,10,35,62
Fotios Zoumpos,Panathinaikos,2,6,1,2,0.5,0,1,0,1,1,1,0.5,0,0,,0,0,0,0,0,0,0,0,2
Fran Vazquez,Regal FC Barcelona,20,344,66,101,0.653,0,0,,66,101,0.653,0.653,30,40,0.75,24,63,87,11,5,19,17,48,162
Gasper Vidmar,Fenerbahçe,4,80,11,19,0.579,0,0,,11,19,0.579,0.579,12,21,0.571,9,10,19,0,6,4,8,15,34
Gerald Fitch,Unicaja Malaga,3,74,10,28,0.357,2,14,0.143,8,14,0.571,0.393,4,5,0.8,3,9,12,6,4,0,7,3,26
Giorgi Shermadini,KK Union Olimpija,16,250,40,60,0.667,0,4,0,40,56,0.714,0.667,39,46,0.848,25,30,55,8,5,17,22,40,119
Giorgos Bogris,Panathinaikos,2,6,0,5,0,0,0,,0,5,0,0,0,0,,0,1,1,1,0,1,0,2,0
Giorgos Printezis,Unicaja Malaga,14,218,32,83,0.386,4,22,0.182,28,61,0.459,0.41,11,16,0.688,12,26,38,4,3,2,15,18,79
Goran Jagodnik,KK Union Olimpija,16,328,53,119,0.445,23,59,0.39,30,60,0.5,0.542,38,42,0.905,9,39,48,12,9,0,20,49,167
Goran Vrbanc,Cibona Zagreb,10,197,20,45,0.444,9,27,0.333,11,18,0.611,0.544,5,5,1,0,11,11,8,4,0,12,16,54
Guillem Rubio,Unicaja Malaga,13,185,15,38,0.395,4,17,0.235,11,21,0.524,0.447,20,28,0.714,13,22,35,7,1,0,10,28,54
Gustavo Barrera,Unicaja Malaga,6,83,4,16,0.25,0,4,0,4,12,0.333,0.25,6,7,0.857,2,1,3,15,2,0,10,9,14
Guy Pnini,Maccabi Tel Aviv,22,436,52,107,0.486,33,72,0.458,19,35,0.543,0.64,21,27,0.778,11,26,37,24,8,1,8,49,158
Herve Toure,Lottomatica Roma,2,20,3,5,0.6,1,1,1,2,4,0.5,0.7,0,0,,1,3,4,0,0,3,1,1,7
Ian Vouyoukas,Panathinaikos,22,178,33,60,0.55,0,0,,33,60,0.55,0.55,24,37,0.649,11,14,25,5,5,9,16,30,90
Ibrahim Jaaber,Armani Jeans Milano,10,246,42,85,0.494,12,34,0.353,30,51,0.588,0.565,12,16,0.75,10,7,17,24,7,3,8,30,108
Igor Milosevic,Lietuvos rytas,6,81,9,21,0.429,0,5,0,9,16,0.563,0.429,9,12,0.75,1,9,10,13,3,0,7,22,27
Igor Rakocevic,Efes Pilsen,14,419,75,164,0.457,27,62,0.435,48,102,0.471,0.54,64,73,0.877,5,28,33,24,10,0,36,20,241
Ioann Iarochevitch,Spirou Charleroi,3,10,0,1,0,0,0,,0,1,0,0,0,0,,0,0,0,1,0,0,1,4,0
Ioannis Karamalegkos,Panathinaikos,1,1,0,0,,0,0,,0,0,,,0,0,,0,0,0,0,0,0,0,0,0
Ivan Garcia,Regal FC Barcelona,1,3,1,1,1,0,0,,1,1,1,1,0,0,,0,0,0,0,0,0,0,0,2
Jacopo Giachetti,Lottomatica Roma,6,111,9,22,0.409,3,8,0.375,6,14,0.429,0.477,13,14,0.929,1,5,6,10,2,0,9,14,34
Jaka Klobucar,Partizan,16,170,15,48,0.313,6,31,0.194,9,17,0.529,0.375,10,16,0.625,1,12,13,11,7,0,16,23,46
Jaka Lakovic,Regal FC Barcelona,19,295,40,94,0.426,23,63,0.365,17,31,0.548,0.548,18,28,0.643,0,9,9,36,4,1,25,23,121
James Augustine,Valencia Basket,8,118,12,24,0.5,0,1,0,12,23,0.522,0.5,3,6,0.5,8,17,25,4,2,1,7,8,27
James Gist,Partizan,14,419,53,138,0.384,21,45,0.467,32,93,0.344,0.46,32,47,0.681,23,74,97,23,14,14,41,36,159
Jamon Gordon,Olympiacos,19,371,32,75,0.427,4,13,0.308,28,62,0.452,0.453,18,27,0.667,13,37,50,28,30,3,12,36,86
Jamont Gordon,CSKA Moscow,10,268,49,102,0.48,7,33,0.212,42,69,0.609,0.515,26,38,0.684,11,37,48,37,9,6,31,19,131
Jan Jagla,Asseco Prokom,10,208,21,56,0.375,10,29,0.345,11,27,0.407,0.464,4,6,0.667,22,32,54,4,5,4,18,21,56
Jan Span,KK Union Olimpija,3,29,1,5,0.2,1,3,0.333,0,2,0,0.3,2,2,1,0,1,1,4,1,0,2,5,5
Jan Vesely,Partizan,15,405,59,110,0.536,10,28,0.357,49,82,0.598,0.582,24,54,0.444,27,27,54,16,19,13,24,45,152
Jeleel Akindele,Montepaschi Siena,6,48,5,12,0.417,0,0,,5,12,0.417,0.417,10,14,0.714,5,9,14,0,0,3,5,8,20
Jeremy Pargo,Maccabi Tel Aviv,22,660,105,227,0.463,29,80,0.363,76,147,0.517,0.526,46,68,0.676,17,61,78,94,23,0,48,65,285
Jeremy Richardson,Valencia Basket,13,254,33,76,0.434,12,32,0.375,21,44,0.477,0.513,6,8,0.75,3,28,31,2,3,2,14,19,84
Joe Ingles,Regal FC Barcelona,15,236,30,65,0.462,7,30,0.233,23,35,0.657,0.515,8,11,0.727,4,13,17,18,12,1,13,20,75
Joel Freeland,Unicaja Malaga,15,383,82,136,0.603,3,11,0.273,79,125,0.632,0.614,41,52,0.788,27,68,95,19,10,9,16,39,208
John Goldsberry,Brose Baskets,9,249,13,38,0.342,10,29,0.345,3,9,0.333,0.474,4,6,0.667,2,19,21,28,17,0,10,28,40
Jonas Maciulis,Armani Jeans Milano,6,139,25,53,0.472,7,12,0.583,18,41,0.439,0.538,8,13,0.615,6,16,22,9,9,2,7,16,65
Jonas Valanciunas,Lietuvos rytas,15,231,46,65,0.708,0,0,,46,65,0.708,0.708,23,26,0.885,27,60,87,3,3,10,21,46,115
Jorge Garbajosa,Real Madrid,11,178,19,45,0.422,10,29,0.345,9,16,0.563,0.533,11,14,0.786,8,22,30,3,7,5,4,12,59
Jose Simeon,Valencia Basket,7,53,3,15,0.2,1,2,0.5,2,13,0.154,0.233,2,4,0.5,3,4,7,5,2,0,3,6,9
Joseph Gomis,Spirou Charleroi,10,303,41,103,0.398,11,37,0.297,30,66,0.455,0.451,11,13,0.846,4,19,23,20,8,0,19,18,104
Josh Fisher,Real Madrid,2,4,0,2,0,0,1,0,0,1,0,0,0,0,,0,1,1,0,0,0,0,0,0
Josh Heytvelt,Lottomatica Roma,10,154,21,46,0.457,6,18,0.333,15,28,0.536,0.522,5,7,0.714,12,17,29,1,7,6,7,20,53
JR Giddens,Asseco Prokom,10,244,34,71,0.479,9,19,0.474,25,52,0.481,0.542,13,17,0.765,10,42,52,8,5,1,11,26,90
JR Holden,CSKA Moscow,10,297,24,91,0.264,13,44,0.295,11,47,0.234,0.335,3,6,0.5,1,18,19,34,5,0,18,16,64
Juan Carlos Navarro,Regal FC Barcelona,15,398,66,138,0.478,33,83,0.398,33,55,0.6,0.598,46,53,0.868,3,19,22,42,5,0,33,27,211
Jure Lalic,Cibona Zagreb,2,40,9,13,0.692,0,0,,9,13,0.692,0.692,3,6,0.5,6,3,9,2,1,0,0,9,21
Justin Hamilton,Spirou Charleroi,10,228,14,36,0.389,2,13,0.154,12,23,0.522,0.417,1,2,0.5,2,21,23,19,9,0,7,16,31
Karlo Vragovic,Cibona Zagreb,10,96,4,10,0.4,0,2,0,4,8,0.5,0.4,7,8,0.875,4,5,9,8,2,0,9,12,15
Karsten Tadda,Brose Baskets,10,93,3,14,0.214,2,10,0.2,1,4,0.25,0.286,0,0,,1,5,6,3,2,0,4,10,8
Kaya Peker,Fenerbahçe,14,221,29,45,0.644,0,1,0,29,44,0.659,0.644,5,11,0.455,9,38,47,19,14,5,13,37,63
Keith Langford,BC Khimki,10,346,63,131,0.481,13,37,0.351,50,94,0.532,0.531,48,67,0.716,7,34,41,25,8,3,23,25,187
Kenan Bajramovic,Lietuvos rytas,14,367,57,144,0.396,10,43,0.233,47,101,0.465,0.431,36,47,0.766,17,56,73,20,9,3,20,35,160
Kenny Gregory,KK Union Olimpija,16,554,101,204,0.495,4,18,0.222,97,186,0.522,0.505,18,35,0.514,32,65,97,26,10,5,27,37,224
Kerem Gonlum,Efes Pilsen,15,380,55,94,0.585,2,10,0.2,53,84,0.631,0.596,29,37,0.784,27,59,86,15,7,3,21,27,141
Kerem Tunceri,Efes Pilsen,16,358,46,105,0.438,23,56,0.411,23,49,0.469,0.548,30,32,0.938,9,19,28,56,16,1,38,20,145
Kevinn Pinkney,KK Union Olimpija,15,299,54,106,0.509,14,33,0.424,40,73,0.548,0.575,38,45,0.844,18,35,53,15,14,6,21,45,160
Khalid El Amin,Lietuvos rytas,15,392,65,136,0.478,21,61,0.344,44,75,0.587,0.555,31,33,0.939,8,20,28,49,22,1,27,42,182
Klemen Lorbek,KK Union Olimpija,3,4,0,1,0,0,0,,0,1,0,0,1,2,0.5,0,0,0,0,0,0,0,2,1
Kosta Perovic,Regal FC Barcelona,17,211,36,59,0.61,0,0,,36,59,0.61,0.61,25,36,0.694,20,31,51,5,6,9,9,38,97
Kostas Kaimakoglou,Panathinaikos,18,185,13,35,0.371,6,17,0.353,7,18,0.389,0.457,25,28,0.893,13,30,43,10,10,2,10,16,57
Kostas Papanikolaou,Olympiacos,16,219,21,47,0.447,10,23,0.435,11,24,0.458,0.553,11,17,0.647,18,32,50,4,9,1,8,33,63
Kostas Tsartsaris,Panathinaikos,22,343,42,75,0.56,5,17,0.294,37,58,0.638,0.593,33,43,0.767,23,44,67,14,14,4,24,70,122
Kresimir Loncar,BC Khimki,10,203,33,71,0.465,3,17,0.176,30,54,0.556,0.486,24,32,0.75,14,27,41,7,7,5,11,24,93
Ksistof Lavrinovic,Montepaschi Siena,21,519,82,178,0.461,20,62,0.323,62,116,0.534,0.517,64,85,0.753,29,75,104,26,16,7,40,50,248
Kyle Hines,Brose Baskets,10,236,54,84,0.643,0,0,,54,84,0.643,0.643,21,45,0.467,26,28,54,5,8,11,25,33,129
Lawrence Roberts,Efes Pilsen,16,334,37,85,0.435,11,29,0.379,26,56,0.464,0.5,19,32,0.594,28,53,81,13,14,10,12,55,104
Leon Radosevic,Cibona Zagreb,9,294,47,93,0.505,0,1,0,47,92,0.511,0.505,22,27,0.815,13,44,57,12,11,4,12,23,116
Lior Eliyahu,Maccabi Tel Aviv,21,433,105,178,0.59,1,5,0.2,104,173,0.601,0.593,17,23,0.739,23,56,79,21,17,10,18,34,228
Loukas Mavrokefalidis,Olympiacos,18,320,62,122,0.508,1,6,0.167,61,116,0.526,0.512,27,34,0.794,22,50,72,10,5,6,22,41,152
Luc Arthur Vebobe,Cholet Basket,9,171,21,35,0.6,0,1,0,21,34,0.618,0.6,7,14,0.5,15,22,37,12,8,3,9,24,49
Luca Vitali,Lottomatica Roma,10,191,20,51,0.392,6,15,0.4,14,36,0.389,0.451,14,22,0.636,4,14,18,16,9,0,14,23,60
Luigi Datome,Lottomatica Roma,13,319,46,105,0.438,18,49,0.367,28,56,0.5,0.524,8,8,1,14,42,56,9,14,5,17,39,118
Lynn Greer,Fenerbahçe,10,112,17,35,0.486,6,15,0.4,11,20,0.55,0.571,10,10,1,1,11,12,18,5,0,14,14,50
Malik Hairston,Montepaschi Siena,16,299,51,112,0.455,7,19,0.368,44,93,0.473,0.487,28,39,0.718,28,23,51,16,10,5,14,33,137
Mamoutou Diarra,Cholet Basket,10,116,7,30,0.233,2,11,0.182,5,19,0.263,0.267,6,8,0.75,1,10,11,4,2,0,9,14,22
Mantas Kalnietis,BC Zalgiris,15,333,53,103,0.515,13,35,0.371,40,68,0.588,0.578,18,24,0.75,7,35,42,28,3,1,33,15,137
Marc Fernandez,Valencia Basket,4,36,3,10,0.3,1,5,0.2,2,5,0.4,0.35,1,1,1,2,2,4,0,0,0,2,3,8
Marcelo Huertas,Caja Laboral,20,574,69,150,0.46,23,52,0.442,46,98,0.469,0.537,45,52,0.865,15,46,61,111,15,1,53,36,206
Marco Carraretto,Montepaschi Siena,22,297,36,73,0.493,13,33,0.394,23,40,0.575,0.582,9,12,0.75,1,15,16,12,11,0,5,38,94
Marco Mordente,Armani Jeans Milano,10,207,18,51,0.353,8,28,0.286,10,23,0.435,0.431,3,4,0.75,3,7,10,11,6,0,11,24,47
Marcus Brown,BC Zalgiris,6,98,8,34,0.235,4,13,0.308,4,21,0.19,0.294,2,2,1,1,6,7,5,1,1,6,15,22
Marcus Haislip,Caja Laboral,5,51,10,18,0.556,3,9,0.333,7,9,0.778,0.639,0,0,,0,6,6,0,2,3,2,7,23
Marcus Johnson,Cibona Zagreb,5,86,4,18,0.222,0,4,0,4,14,0.286,0.222,0,2,0,2,10,12,2,4,2,6,8,8
Marijonas Petravicius,Armani Jeans Milano,5,77,17,27,0.63,0,0,,17,27,0.63,0.63,7,10,0.7,8,8,16,0,2,0,5,15,41
Mario Delas,Cibona Zagreb,6,118,8,27,0.296,4,14,0.286,4,13,0.308,0.37,6,8,0.75,10,9,19,4,1,0,9,15,26
Marko Jaric,Montepaschi Siena,12,150,26,60,0.433,3,19,0.158,23,41,0.561,0.458,6,8,0.75,4,13,17,15,12,0,17,16,61
Marko Keselj,Olympiacos,12,148,16,34,0.471,10,23,0.435,6,11,0.545,0.618,4,8,0.5,1,11,12,2,3,3,7,20,46
Marko Tomas,Fenerbahçe,15,341,41,102,0.402,23,55,0.418,18,47,0.383,0.515,23,34,0.676,14,33,47,20,11,0,21,38,128
Marque Perry,KK Union Olimpija,12,142,6,25,0.24,0,6,0,6,19,0.316,0.24,4,4,1,0,8,8,13,4,0,15,11,16
Martin Buesa,Caja Laboral,1,3,0,0,,0,0,,0,0,,,0,0,,0,1,1,0,0,0,0,0,0
Martin Rancik,Caja Laboral,5,89,22,38,0.579,3,6,0.5,19,32,0.594,0.618,1,1,1,4,11,15,0,0,1,3,14,48
Martynas Gecevicius,Lietuvos rytas,15,431,61,132,0.462,28,68,0.412,33,64,0.516,0.568,26,31,0.839,4,41,45,39,8,1,29,23,176
Martynas Pocius,BC Zalgiris,16,382,55,139,0.396,18,60,0.3,37,79,0.468,0.46,46,65,0.708,8,35,43,38,7,2,36,34,174
Mason Rocca,Armani Jeans Milano,10,219,24,53,0.453,0,1,0,24,52,0.462,0.453,16,27,0.593,20,27,47,2,7,0,13,36,64
Mateusz Kostrzewski,Asseco Prokom,2,14,2,3,0.667,0,1,0,2,2,1,0.667,0,0,,0,0,0,1,1,1,2,1,4
Matjaz Smodis,CSKA Moscow,10,195,20,60,0.333,7,23,0.304,13,37,0.351,0.392,21,30,0.7,8,19,27,4,2,0,9,25,68
Matt Nielsen,Olympiacos,14,223,22,57,0.386,2,14,0.143,20,43,0.465,0.404,15,20,0.75,12,28,40,8,8,1,18,25,61
Maurice Stuckey,Brose Baskets,4,18,3,6,0.5,1,4,0.25,2,2,1,0.583,0,0,,0,0,0,0,0,0,2,3,7
Michalis Pelekanos,Olympiacos,6,38,1,12,0.083,0,7,0,1,5,0.2,0.083,2,2,1,1,6,7,2,2,0,2,6,4
Mike Batiste,Panathinaikos,20,530,104,178,0.584,0,3,0,104,175,0.594,0.584,56,77,0.727,30,79,109,16,16,17,41,57,264
Mike Nardi,Armani Jeans Milano,4,6,1,2,0.5,1,1,1,0,1,0,0.75,0,0,,0,2,2,1,0,0,1,3,3
Mike Wilks,Asseco Prokom,9,119,10,34,0.294,2,5,0.4,8,29,0.276,0.324,8,11,0.727,3,5,8,4,8,0,13,13,30
Milan Macvan,Maccabi Tel Aviv,12,108,14,32,0.438,1,5,0.2,13,27,0.481,0.453,13,16,0.813,8,12,20,5,2,3,8,10,42
Milenko Tepic,Panathinaikos,19,182,17,53,0.321,2,14,0.143,15,39,0.385,0.34,12,17,0.706,7,13,20,13,5,0,11,14,48
Milko Bjelica,Lietuvos rytas,16,418,72,135,0.533,12,43,0.279,60,92,0.652,0.578,40,55,0.727,32,43,75,22,11,6,35,56,196
Milos Teodosic,Olympiacos,18,459,56,171,0.327,31,107,0.29,25,64,0.391,0.418,53,59,0.898,5,43,48,65,12,2,27,37,196
Milovan Rakovic,Montepaschi Siena,22,383,81,149,0.544,0,0,,81,149,0.544,0.544,14,25,0.56,38,46,84,8,15,4,30,61,176
Mindaugas Kuzminskas,BC Zalgiris,8,55,5,14,0.357,1,6,0.167,4,8,0.5,0.393,2,3,0.667,3,5,8,1,2,0,4,4,13
Miroslav Raduljica,Efes Pilsen,4,15,2,2,1,0,0,,2,2,1,1,1,1,1,0,0,0,2,1,0,1,5,5
Mirsad Turkcan,Fenerbahçe,12,253,37,78,0.474,13,36,0.361,24,42,0.571,0.558,8,20,0.4,34,54,88,10,9,2,12,14,95
Mirza Begic,Real Madrid,6,32,10,14,0.714,0,0,,10,14,0.714,0.714,1,2,0.5,1,3,4,0,1,1,2,8,21
Mirza Begic,BC Zalgiris,10,216,34,60,0.567,0,0,,34,60,0.567,0.567,29,40,0.725,12,37,49,5,6,23,18,33,97
Mirza Teletovic,Caja Laboral,20,684,112,272,0.412,49,136,0.36,63,136,0.463,0.502,36,53,0.679,26,84,110,16,12,10,24,39,309
Morris Finley,Armani Jeans Milano,10,295,40,74,0.541,13,30,0.433,27,44,0.614,0.628,17,20,0.85,6,11,17,33,12,0,23,19,110
Nando De Colo,Valencia Basket,19,409,54,161,0.335,16,58,0.276,38,103,0.369,0.385,67,70,0.957,14,36,50,31,26,3,47,41,191
Nathan Jawai,Partizan,16,366,51,111,0.459,0,0,,51,111,0.459,0.459,44,56,0.786,25,55,80,14,9,11,27,43,146
Nedzad Sinanovic,Unicaja Malaga,5,89,21,32,0.656,0,0,,21,32,0.656,0.656,12,13,0.923,7,20,27,1,2,6,6,10,54
Nemanja Bjelica,Caja Laboral,13,117,5,20,0.25,2,9,0.222,3,11,0.273,0.3,3,6,0.5,4,18,22,7,3,0,1,27,15
Nemanja Gordic,Lottomatica Roma,6,135,19,47,0.404,14,30,0.467,5,17,0.294,0.553,6,9,0.667,0,2,2,15,1,0,9,21,58
Nemanja Jaramaz,Partizan,2,2,0,0,,0,0,,0,0,,,0,0,,0,0,0,0,0,0,0,0,0
Nick Calathes,Panathinaikos,22,341,41,73,0.562,6,17,0.353,35,56,0.625,0.603,18,26,0.692,7,28,35,33,15,3,27,41,106
Nicolo Melli,Armani Jeans Milano,10,111,12,32,0.375,3,10,0.3,9,22,0.409,0.422,6,9,0.667,9,15,24,2,3,4,9,20,33
Nihad Djedovic,Lottomatica Roma,15,410,55,129,0.426,7,36,0.194,48,93,0.516,0.453,23,31,0.742,5,42,47,31,25,5,38,34,140
Nikita Kurbanov,CSKA Moscow,7,40,4,6,0.667,0,2,0,4,4,1,0.667,2,2,1,1,6,7,2,2,1,5,5,10
Nikola Mirotic,Real Madrid,20,300,48,96,0.5,12,31,0.387,36,65,0.554,0.563,24,28,0.857,21,44,65,12,9,10,13,26,132
Nikola Vujcic,Efes Pilsen,15,272,37,90,0.411,0,1,0,37,89,0.416,0.411,23,33,0.697,18,29,47,30,9,3,28,24,97
Nikos Zisis,Montepaschi Siena,22,480,42,120,0.35,9,35,0.257,33,85,0.388,0.388,39,46,0.848,9,31,40,58,20,0,23,49,132
Novica Velickovic,Real Madrid,19,230,25,60,0.417,2,6,0.333,23,54,0.426,0.433,12,26,0.462,20,33,53,9,3,4,20,23,64
Oguz Savas,Fenerbahçe,16,283,41,77,0.532,1,2,0.5,40,75,0.533,0.539,47,56,0.839,21,39,60,17,10,5,20,33,130
Oleksiy Pecherov,Armani Jeans Milano,3,58,12,26,0.462,6,17,0.353,6,9,0.667,0.577,5,5,1,2,6,8,0,1,2,1,7,35
Oliver Lafayette,Partizan,6,154,15,68,0.221,4,26,0.154,11,42,0.262,0.25,17,26,0.654,8,14,22,20,8,0,18,11,51
Omar Cook,Valencia Basket,21,630,54,140,0.386,26,72,0.361,28,68,0.412,0.479,34,43,0.791,7,43,50,116,38,1,42,54,168
Omar Samhan,BC Zalgiris,3,23,0,1,0,0,0,,0,1,0,0,2,2,1,1,2,3,0,0,1,1,4,2
Omer Onan,Fenerbahçe,16,397,53,106,0.5,18,44,0.409,35,62,0.565,0.585,13,20,0.65,1,16,17,14,14,0,11,42,137
Pablo Almazan,Unicaja Malaga,4,43,3,6,0.5,2,4,0.5,1,2,0.5,0.667,4,4,1,1,7,8,3,2,0,3,3,12
Pablo Prigioni,Real Madrid,18,459,30,81,0.37,22,64,0.344,8,17,0.471,0.506,16,21,0.762,9,38,47,61,25,0,21,38,98
Panagiotis Vasilopoulos,Olympiacos,2,8,0,1,0,0,0,,0,1,0,0,0,2,0,0,1,1,0,0,1,0,1,0
Pape Sow,Caja Laboral,6,69,6,9,0.667,0,0,,6,9,0.667,0.667,8,11,0.727,6,13,19,2,3,3,5,16,20
Pau Ribas,Caja Laboral,20,258,20,45,0.444,8,25,0.32,12,20,0.6,0.533,1,5,0.2,11,22,33,20,9,0,11,28,49
Paulius Jankunas,BC Zalgiris,16,421,59,124,0.476,5,33,0.152,54,91,0.593,0.496,27,33,0.818,29,81,110,16,9,6,34,37,150
Petar Bozic,Partizan,14,169,11,36,0.306,8,29,0.276,3,7,0.429,0.417,5,8,0.625,4,12,16,11,5,0,13,41,35
Pete Mickeal,Regal FC Barcelona,4,129,19,44,0.432,3,10,0.3,16,34,0.471,0.466,15,18,0.833,3,15,18,6,1,2,2,8,56
Philip Neumann,Brose Baskets,1,2,0,0,,0,0,,0,0,,,0,0,,0,0,0,0,0,0,1,0,0
Pietro Aradori,Montepaschi Siena,14,151,20,46,0.435,9,18,0.5,11,28,0.393,0.533,19,25,0.76,5,17,22,10,5,0,6,10,68
Piotr Szczotka,Asseco Prokom,10,138,9,19,0.474,1,2,0.5,8,17,0.471,0.5,1,3,0.333,7,12,19,5,4,0,2,20,20
Predrag Suput,Brose Baskets,9,193,37,76,0.487,7,23,0.304,30,53,0.566,0.533,9,12,0.75,4,15,19,15,8,1,21,24,90
Rafa Freire,Unicaja Malaga,13,159,11,33,0.333,1,13,0.077,10,20,0.5,0.348,3,8,0.375,4,14,18,22,9,0,19,27,26
Rafael Martinez,Valencia Basket,21,609,74,178,0.416,36,96,0.375,38,82,0.463,0.517,40,52,0.769,6,39,45,32,16,1,41,46,224
Ramunas Siskauskas,CSKA Moscow,7,175,19,45,0.422,8,23,0.348,11,22,0.5,0.511,3,6,0.5,3,25,28,6,9,1,7,6,49
Randal Falker,Cholet Basket,9,192,25,48,0.521,0,0,,25,48,0.521,0.521,9,18,0.5,24,29,53,11,5,12,11,28,59
Rasho Nesterovic,Olympiacos,20,416,94,141,0.667,0,2,0,94,139,0.676,0.667,30,46,0.652,51,57,108,11,7,20,26,48,218
Rasko Katic,Partizan,16,272,44,90,0.489,0,0,,44,90,0.489,0.489,23,31,0.742,35,32,67,5,6,4,18,51,111
Ratko Varda,Asseco Prokom,10,207,45,88,0.511,9,17,0.529,36,71,0.507,0.563,34,48,0.708,19,26,45,8,2,3,19,33,133
Raul Lopez,BC Khimki,10,220,27,55,0.491,21,40,0.525,6,15,0.4,0.682,7,8,0.875,4,17,21,30,15,0,10,28,82
Reyshawn Terry,Brose Baskets,10,181,22,58,0.379,6,24,0.25,16,34,0.471,0.431,21,25,0.84,7,36,43,6,5,0,16,27,71
Richard Hendrix,Maccabi Tel Aviv,21,294,52,92,0.565,0,0,,52,92,0.565,0.565,13,24,0.542,37,63,100,4,12,18,13,51,117
Ricky Rubio,Regal FC Barcelona,20,456,31,100,0.31,11,49,0.224,20,51,0.392,0.365,56,67,0.836,17,48,65,71,33,1,36,48,129
Rimantas Kaukenas,Montepaschi Siena,20,506,89,200,0.445,16,52,0.308,73,148,0.493,0.485,46,51,0.902,12,28,40,38,20,2,40,50,240
Robert Archibald,Unicaja Malaga,13,202,38,71,0.535,0,0,,38,71,0.535,0.535,30,56,0.536,25,28,53,5,5,4,19,30,106
Robert Witka,Asseco Prokom,1,2,0,0,,0,0,,0,0,,,0,0,,0,0,0,0,0,0,1,0,0
Robertas Javtokas,Valencia Basket,21,521,74,129,0.574,1,2,0.5,73,127,0.575,0.578,24,58,0.414,43,69,112,14,13,15,34,55,173
Roderick Blakney,Unicaja Malaga,12,268,29,72,0.403,12,34,0.353,17,38,0.447,0.486,18,21,0.857,5,14,19,42,11,1,15,26,88
Roger Grimau,Regal FC Barcelona,20,296,38,76,0.5,4,13,0.308,34,63,0.54,0.526,9,14,0.643,3,24,27,15,11,3,15,45,89
Rok Stipcevic,Cibona Zagreb,9,307,33,82,0.402,16,42,0.381,17,40,0.425,0.5,11,16,0.688,5,20,25,37,9,0,24,23,93
Roko Ukic,Fenerbahçe,14,391,70,145,0.483,18,43,0.419,52,102,0.51,0.545,27,33,0.818,8,27,35,49,13,2,16,25,185
Romain Duport,Cholet Basket,3,15,2,7,0.286,0,2,0,2,5,0.4,0.286,0,0,,0,0,0,0,0,0,1,4,4
Romain Sato,Panathinaikos,21,548,60,145,0.414,19,49,0.388,41,96,0.427,0.479,52,64,0.813,22,61,83,24,15,3,25,47,191
Ronald Murray,Efes Pilsen,6,77,9,32,0.281,2,13,0.154,7,19,0.368,0.313,5,6,0.833,0,5,5,6,5,0,10,9,25
Ronnie Burrell,Asseco Prokom,9,156,13,34,0.382,1,5,0.2,12,29,0.414,0.397,6,8,0.75,11,20,31,4,1,0,13,19,33
Sammy Mejia,Cholet Basket,10,324,57,124,0.46,12,34,0.353,45,90,0.5,0.508,25,32,0.781,21,34,55,27,11,1,26,19,151
Samo Udrih,KK Union Olimpija,3,68,1,13,0.077,0,6,0,1,7,0.143,0.077,1,2,0.5,3,2,5,8,0,0,8,8,3
Sarunas Jasikevicius,Fenerbahçe,6,92,11,27,0.407,3,8,0.375,8,19,0.421,0.463,4,5,0.8,1,5,6,9,1,0,19,9,29
Saso Ozbolt,KK Union Olimpija,16,506,44,117,0.376,21,61,0.344,23,56,0.411,0.466,32,43,0.744,9,31,40,37,27,1,34,48,141
Sasu Salin,KK Union Olimpija,11,61,6,17,0.353,4,12,0.333,2,5,0.4,0.471,4,6,0.667,3,6,9,1,4,0,4,13,20
Saul Blanco,Unicaja Malaga,13,299,38,96,0.396,12,33,0.364,26,63,0.413,0.458,21,22,0.955,16,23,39,12,12,3,13,24,109
Sava Lesic,Partizan,1,21,0,3,0,0,0,,0,3,0,0,4,4,1,4,2,6,0,0,0,0,3,4
Sean May,Fenerbahçe,8,97,13,32,0.406,0,3,0,13,29,0.448,0.406,8,11,0.727,6,16,22,4,4,2,3,16,34
Sergei Lishouk,Valencia Basket,21,340,47,106,0.443,1,3,0.333,46,103,0.447,0.448,37,69,0.536,45,57,102,9,6,18,17,67,132
Sergei Monia,BC Khimki,10,254,24,58,0.414,16,41,0.39,8,17,0.471,0.552,5,7,0.714,7,27,34,7,10,9,16,26,69
Sergey Bykov,CSKA Moscow,5,51,4,6,0.667,0,2,0,4,4,1,0.667,6,8,0.75,2,9,11,2,2,0,3,12,14
Sergi Vidal,Real Madrid,11,72,5,16,0.313,2,9,0.222,3,7,0.429,0.375,4,6,0.667,3,8,11,2,3,0,5,1,16
Sergio Llull,Real Madrid,23,644,91,224,0.406,34,99,0.343,57,125,0.456,0.482,58,69,0.841,16,37,53,68,18,2,48,47,274
Sergio Rodriguez,Real Madrid,18,338,38,92,0.413,4,20,0.2,34,72,0.472,0.435,30,32,0.938,11,23,34,55,9,0,35,32,110
Shaun Stonerook,Montepaschi Siena,20,478,27,68,0.397,14,38,0.368,13,30,0.433,0.5,15,22,0.682,9,79,88,34,31,2,22,76,83
Simas Buterlevicius,Lietuvos rytas,2,6,0,0,,0,0,,0,0,,,0,0,,0,0,0,0,0,0,0,0,0
Simas Jasaitis,Lietuvos rytas,6,105,12,34,0.353,4,16,0.25,8,18,0.444,0.412,5,6,0.833,4,10,14,7,2,1,7,9,33
Sinan Guler,Efes Pilsen,15,234,24,56,0.429,5,22,0.227,19,34,0.559,0.473,5,7,0.714,12,17,29,13,15,3,16,30,58
Sofoklis Schortsanitis,Maccabi Tel Aviv,22,422,100,172,0.581,0,0,,100,172,0.581,0.581,65,104,0.625,39,53,92,23,18,14,46,56,265
Stanko Barac,Caja Laboral,20,450,87,150,0.58,5,8,0.625,82,142,0.577,0.597,48,66,0.727,30,75,105,16,9,20,33,56,227
Stefano Mancinelli,Armani Jeans Milano,10,311,38,89,0.427,7,33,0.212,31,56,0.554,0.466,8,11,0.727,10,35,45,26,12,2,8,30,91
Steponas Babrauskas,Lietuvos rytas,14,161,12,33,0.364,8,17,0.471,4,16,0.25,0.485,2,4,0.5,7,6,13,3,5,0,5,27,34
Stipe Krstanovic,Cibona Zagreb,3,16,2,3,0.667,0,1,0,2,2,1,0.667,0,0,,1,3,4,0,2,0,0,3,4
Stratos Perperoglou,Panathinaikos,22,403,50,118,0.424,19,47,0.404,31,71,0.437,0.504,37,54,0.685,16,34,50,16,12,7,29,46,156
Sven Smajlagic,Cibona Zagreb,4,10,0,2,0,0,2,0,0,0,,0,0,0,,0,0,0,0,0,0,1,4,0
Tadas Klimavicius,BC Zalgiris,16,258,24,65,0.369,6,26,0.231,18,39,0.462,0.415,8,11,0.727,16,31,47,7,5,5,21,26,62
Tal Burstein,Maccabi Tel Aviv,21,277,28,73,0.384,5,24,0.208,23,49,0.469,0.418,15,23,0.652,8,30,38,23,12,0,8,25,76
Tarence Kinsey,Fenerbahçe,14,312,47,97,0.485,3,12,0.25,44,85,0.518,0.5,20,31,0.645,12,27,39,16,20,1,18,29,117
Terence Morris,Regal FC Barcelona,20,390,50,113,0.442,22,64,0.344,28,49,0.571,0.54,9,13,0.692,16,64,80,13,14,11,21,21,131
Terrell McIntyre,Unicaja Malaga,10,218,17,69,0.246,11,47,0.234,6,22,0.273,0.326,12,13,0.923,3,6,9,28,6,0,20,22,57
Theodoros Papaloukas,Olympiacos,18,385,39,83,0.47,6,28,0.214,33,55,0.6,0.506,14,23,0.609,3,43,46,69,28,0,36,33,98
Thomas Kelati,BC Khimki,5,91,8,25,0.32,5,16,0.313,3,9,0.333,0.42,1,2,0.5,0,7,7,6,1,0,5,10,22
Tibor Pleiss,Brose Baskets,10,191,24,58,0.414,4,9,0.444,20,49,0.408,0.448,15,19,0.789,10,53,63,9,1,15,12,35,67
Tomas Delininkaitis,BC Zalgiris,16,314,38,99,0.384,26,66,0.394,12,33,0.364,0.515,38,45,0.844,3,28,31,32,8,0,25,29,140
Tomas Ress,Montepaschi Siena,18,202,19,35,0.543,4,10,0.4,15,25,0.6,0.6,6,10,0.6,7,25,32,3,5,10,9,23,48
Tomas Van Den Spiegel,Armani Jeans Milano,5,38,2,6,0.333,0,0,,2,6,0.333,0.333,6,8,0.75,4,5,9,0,0,1,9,8,10
Tomislav Zubcic,Cibona Zagreb,10,247,31,70,0.443,8,23,0.348,23,47,0.489,0.5,20,26,0.769,17,34,51,9,6,1,18,22,90
Tommaso Ingrosso,Montepaschi Siena,1,1,0,0,,0,0,,0,0,,,0,0,,0,0,0,0,0,0,1,0,0
Toni Brnas,Cibona Zagreb,6,68,2,13,0.154,1,4,0.25,1,9,0.111,0.192,1,1,1,1,5,6,0,3,1,3,9,6
Trajan Langdon,CSKA Moscow,10,275,29,73,0.397,8,35,0.229,21,38,0.553,0.452,17,24,0.708,4,18,22,5,2,0,17,18,83
Travis Watson,BC Zalgiris,15,270,38,70,0.543,0,0,,38,70,0.543,0.543,23,38,0.605,24,46,70,11,15,8,30,58,99
Trent Plaisted,BC Zalgiris,3,53,10,17,0.588,0,0,,10,17,0.588,0.588,3,6,0.5,5,12,17,1,2,2,6,9,23
Uros Tripkovic,Unicaja Malaga,15,269,43,104,0.413,25,63,0.397,18,41,0.439,0.534,11,12,0.917,5,17,22,17,10,0,13,27,122
Vadim Panin,BC Khimki,5,45,0,7,0,0,5,0,0,2,0,0,2,2,1,4,7,11,3,1,0,1,4,2
Vassilis Spanoulis,Olympiacos,20,590,83,187,0.444,26,75,0.347,57,112,0.509,0.513,92,108,0.852,4,31,35,85,23,1,77,47,284
Vyacheslav Zaytsev,BC Khimki,3,10,0,2,0,0,1,0,0,1,0,0,0,0,,0,0,0,0,1,0,0,2,0
Victor Arteaga,Real Madrid,1,3,1,3,0.333,0,0,,1,3,0.333,0.333,0,0,,0,0,0,0,0,1,1,1,2
Victor Claver,Valencia Basket,14,386,51,108,0.472,14,38,0.368,37,70,0.529,0.537,37,44,0.841,13,55,68,19,20,5,35,35,153
Victor Sada,Regal FC Barcelona,20,332,15,46,0.326,2,22,0.091,13,24,0.542,0.348,8,10,0.8,11,39,50,44,11,1,24,34,40
Viktor Khryapa,CSKA Moscow,3,57,3,11,0.273,1,3,0.333,2,8,0.25,0.318,2,2,1,4,11,15,7,3,0,4,4,9
Vitaly Fridzon,BC Khimki,9,202,21,64,0.328,10,32,0.313,11,32,0.344,0.406,22,29,0.759,13,24,37,13,6,1,12,21,74
Vladimir Boisa,KK Union Olimpija,4,27,0,0,,0,0,,0,0,,,0,0,,0,2,2,2,0,0,1,5,0
Vladimir Dasic,Lottomatica Roma,16,419,49,121,0.405,15,38,0.395,34,83,0.41,0.467,22,35,0.629,20,56,76,14,23,3,23,31,135
Vladimir Lucic,Partizan,15,161,12,23,0.522,2,6,0.333,10,17,0.588,0.565,10,15,0.667,7,21,28,9,3,4,3,22,36
Vlado Ilievski,KK Union Olimpija,15,522,52,140,0.371,23,72,0.319,29,68,0.426,0.454,35,40,0.875,4,33,37,61,26,0,39,35,162
Vule Avdalovic,Cholet Basket,10,277,24,71,0.338,8,32,0.25,16,39,0.41,0.394,29,36,0.806,4,14,18,36,4,0,15,26,85
Yaniv Green,Maccabi Tel Aviv,8,62,11,20,0.55,0,0,,11,20,0.55,0.55,3,10,0.3,8,8,16,0,2,3,3,9,25
Ioannis Bourousis,Olympiacos,18,313,71,134,0.53,11,30,0.367,60,104,0.577,0.571,40,59,0.678,30,88,118,13,10,24,32,38,193
Yotam Halperin,Olympiacos,13,187,23,42,0.548,9,20,0.45,14,22,0.636,0.655,3,4,0.75,5,20,25,17,12,2,9,20,58
Zoran Erceg,Olympiacos,16,285,31,75,0.413,11,37,0.297,20,38,0.526,0.487,21,24,0.875,24,26,50,8,7,6,17,31,94
Zoran Planinic,BC Khimki,10,290,40,82,0.488,9,31,0.29,31,51,0.608,0.543,22,31,0.71,8,34,42,31,9,2,21,29,111
Zoran Vrkic,KK Union Olimpija,6,50,7,12,0.583,2,3,0.667,5,9,0.556,0.667,4,6,0.667,1,10,11,1,2,0,3,6,20